UBIGEO,DISTRITO,REGION,PROVINCIA,NO_NAC,SI_VIV,NO_VIV,TOTAL_POB,TASA_MOV
10101,Chachapoyas,Amazonas,Chachapoyas,2633,22774,7182,32589,0.220381110190555
10102,Asunción,Amazonas,Chachapoyas,22,220,20,262,0.0763358778625954
10103,Balsas,Amazonas,Chachapoyas,111,938,87,1136,0.0765845070422535
10104,Cheto,Amazonas,Chachapoyas,44,533,65,642,0.101246105919003
10105,Chiliquin,Amazonas,Chachapoyas,49,483,53,585,0.0905982905982906
10106,Chuquibamba,Amazonas,Chachapoyas,184,1472,125,1781,0.0701852891633914
10107,Granada,Amazonas,Chachapoyas,31,423,26,480,0.0541666666666667
10108,Huancas,Amazonas,Chachapoyas,31,684,543,1258,0.431637519872814
10109,La Jalca,Amazonas,Chachapoyas,408,3416,154,3978,0.0387129210658622
10110,Leimebamba,Amazonas,Chachapoyas,284,2850,486,3620,0.134254143646409
10111,Levanto,Amazonas,Chachapoyas,72,648,74,794,0.0931989924433249
10112,Magdalena,Amazonas,Chachapoyas,79,645,128,852,0.150234741784038
10113,Mariscal Castilla,Amazonas,Chachapoyas,113,1021,233,1367,0.170446232626189
10114,Molinopampa,Amazonas,Chachapoyas,165,1782,229,2176,0.105238970588235
10115,Montevideo,Amazonas,Chachapoyas,40,403,53,496,0.106854838709677
10116,Olleros,Amazonas,Chachapoyas,29,305,41,375,0.109333333333333
10117,Quinjalca,Amazonas,Chachapoyas,51,713,5,769,0.00650195058517555
10118,San Francisco de Daguas,Amazonas,Chachapoyas,14,214,67,295,0.227118644067797
10119,San Isidro de Maino,Amazonas,Chachapoyas,48,488,44,580,0.0758620689655172
10120,Soloco,Amazonas,Chachapoyas,87,1077,60,1224,0.0490196078431373
10121,Sonche,Amazonas,Chachapoyas,24,206,17,247,0.0688259109311741
10201,Bagua,Amazonas,Bagua,2200,21740,3162,27102,0.11667035643126
10202,Aramango,Amazonas,Bagua,986,8391,388,9765,0.0397337429595494
10203,Copallin,Amazonas,Bagua,336,4079,180,4595,0.0391730141458107
10204,El Parco,Amazonas,Bagua,106,1065,45,1216,0.0370065789473684
10205,Imaza,Amazonas,Bagua,3587,20563,1012,25162,0.0402193784277879
10206,La Peca,Amazonas,Bagua,546,5299,415,6260,0.0662939297124601
10301,Jumbilla,Amazonas,Bongara,94,1047,196,1337,0.146596858638743
10302,Chisquilla,Amazonas,Bongara,31,223,52,306,0.169934640522876
10303,Churuja,Amazonas,Bongara,23,195,69,287,0.240418118466899
10304,Corosha,Amazonas,Bongara,95,586,91,772,0.117875647668394
10305,Cuispes,Amazonas,Bongara,47,569,53,669,0.0792227204783259
10306,Florida,Amazonas,Bongara,540,4731,728,5999,0.121353558926488
10307,Jazan,Amazonas,Bongara,577,5761,1242,7580,0.163852242744063
10308,Recta,Amazonas,Bongara,17,172,19,208,0.0913461538461538
10309,San Carlos,Amazonas,Bongara,27,440,22,489,0.0449897750511247
10310,Shipasbamba,Amazonas,Bongara,146,1266,127,1539,0.0825211176088369
10311,Valera,Amazonas,Bongara,65,705,104,874,0.118993135011442
10312,Yambrasbamba,Amazonas,Bongara,564,4450,563,5577,0.100950331719562
10401,Nieva,Amazonas,Condorcanqui,2823,14927,876,18626,0.0470310318909052
10402,El Cenepa,Amazonas,Condorcanqui,1531,8263,97,9891,0.00980689515721363
10403,Rio Santiago,Amazonas,Condorcanqui,2339,11518,96,13953,0.0068802408084283
10501,Lamud,Amazonas,Luya,147,1730,350,2227,0.157162101481814
10502,Camporredondo,Amazonas,Luya,755,5244,474,6473,0.0732272516607446
10503,Cocabamba,Amazonas,Luya,229,1578,74,1881,0.0393407761828814
10504,Colcamar,Amazonas,Luya,158,1610,85,1853,0.0458715596330275
10505,Conila,Amazonas,Luya,164,1599,77,1840,0.0418478260869565
10506,Inguilpata,Amazonas,Luya,20,453,25,498,0.0502008032128514
10507,Longuita,Amazonas,Luya,88,721,30,839,0.0357568533969011
10508,Lonya Chico,Amazonas,Luya,62,730,50,842,0.0593824228028504
10509,Luya,Amazonas,Luya,333,3229,397,3959,0.100277847941399
10510,Luya Viejo,Amazonas,Luya,45,324,19,388,0.0489690721649485
10511,María,Amazonas,Luya,62,628,54,744,0.0725806451612903
10512,Ocalli,Amazonas,Luya,341,2877,338,3556,0.0950506186726659
10513,Ocumal,Amazonas,Luya,330,2942,174,3446,0.0504933255948926
10514,Pisuquia,Amazonas,Luya,495,4104,169,4768,0.0354446308724832
10515,Providencia,Amazonas,Luya,121,1116,79,1316,0.0600303951367781
10516,San Cristobal,Amazonas,Luya,48,471,27,546,0.0494505494505495
10517,San Francisco del Yeso,Amazonas,Luya,70,565,60,695,0.0863309352517986
10518,San Jerónimo,Amazonas,Luya,43,554,36,633,0.0568720379146919
10519,San Juan de Lopecancha,Amazonas,Luya,44,346,29,419,0.0692124105011933
10520,Santa Catalina,Amazonas,Luya,232,1514,142,1888,0.0752118644067797
10521,Santo Tomas,Amazonas,Luya,282,2513,217,3012,0.0720451527224436
10522,Tingo,Amazonas,Luya,123,981,161,1265,0.127272727272727
10523,Trita,Amazonas,Luya,133,1112,103,1348,0.0764094955489614
10601,San Nicolás,Amazonas,Rodríguez de Mendoza,462,4277,1277,6016,0.212267287234043
10602,Chirimoto,Amazonas,Rodríguez de Mendoza,305,1919,274,2498,0.10968775020016
10603,Cochamal,Amazonas,Rodríguez de Mendoza,50,498,47,595,0.0789915966386555
10604,Huambo,Amazonas,Rodríguez de Mendoza,134,2334,152,2620,0.0580152671755725
10605,Limabamba,Amazonas,Rodríguez de Mendoza,189,1964,127,2280,0.0557017543859649
10606,Longar,Amazonas,Rodríguez de Mendoza,122,1285,224,1631,0.137339055793991
10607,Mariscal Benavides,Amazonas,Rodríguez de Mendoza,116,1167,223,1506,0.148074369189907
10608,Milpuc,Amazonas,Rodríguez de Mendoza,30,387,36,453,0.0794701986754967
10609,Omia,Amazonas,Rodríguez de Mendoza,1010,6925,858,8793,0.0975776185602184
10610,Santa Rosa,Amazonas,Rodríguez de Mendoza,37,434,41,512,0.080078125
10611,Totora,Amazonas,Rodríguez de Mendoza,17,257,8,282,0.0283687943262411
10612,Vista Alegre,Amazonas,Rodríguez de Mendoza,392,2169,251,2812,0.0892603129445235
10701,Bagua Grande,Amazonas,Utcubamba,4810,40854,5177,50841,0.101827265396039
10702,Cajaruro,Amazonas,Utcubamba,2107,20099,883,23089,0.0382433193295509
10703,Cumba,Amazonas,Utcubamba,796,6646,413,7855,0.052577975811585
10704,El Milagro,Amazonas,Utcubamba,595,4394,836,5825,0.143519313304721
10705,Jamalca,Amazonas,Utcubamba,682,5587,351,6620,0.0530211480362538
10706,Lonya Grande,Amazonas,Utcubamba,1031,8241,808,10080,0.0801587301587302
10707,Yamon,Amazonas,Utcubamba,273,2442,212,2927,0.0724291083020157
20101,Huaraz,Áncash,Huaraz,5087,48372,7437,60896,0.122126248029427
20102,Cochabamba,Áncash,Huaraz,164,1438,37,1639,0.0225747406955461
20103,Colcabamba,Áncash,Huaraz,29,239,26,294,0.0884353741496599
20104,Huanchay,Áncash,Huaraz,106,1438,56,1600,0.035
20105,Independencia,Áncash,Huaraz,6792,60413,8883,76088,0.116746398906529
20106,Jangas,Áncash,Huaraz,408,4016,357,4781,0.0746705710102489
20107,La Libertad,Áncash,Huaraz,123,921,22,1066,0.0206378986866792
20108,Olleros,Áncash,Huaraz,188,2012,151,2351,0.0642279880901744
20109,Pampas Grande,Áncash,Huaraz,73,858,25,956,0.0261506276150628
20110,Pariacoto,Áncash,Huaraz,398,3975,233,4606,0.0505861919235779
20111,Pira,Áncash,Huaraz,295,2851,175,3321,0.0526949713941584
20112,Tarica,Áncash,Huaraz,560,5381,397,6338,0.0626380561691385
20201,Aija,Áncash,Aija,123,1723,171,2017,0.0847793753098661
20202,Coris,Áncash,Aija,136,1450,53,1639,0.0323367907260525
20203,Huacllan,Áncash,Aija,37,306,21,364,0.0576923076923077
20204,La Merced,Áncash,Aija,128,1401,53,1582,0.0335018963337547
20205,Succha,Áncash,Aija,54,611,49,714,0.0686274509803922
20301,Llamellin,Áncash,Antonio Raymondi,292,2734,262,3288,0.079683698296837
20302,Aczo,Áncash,Antonio Raymondi,190,1625,103,1918,0.0537017726798749
20303,Chaccho,Áncash,Antonio Raymondi,128,1179,61,1368,0.0445906432748538
20304,Chingas,Áncash,Antonio Raymondi,177,1525,149,1851,0.0804970286331713
20305,Mirgas,Áncash,Antonio Raymondi,476,3542,49,4067,0.0120481927710843
20306,San Juan de Rontoy,Áncash,Antonio Raymondi,122,1013,23,1158,0.0198618307426598
20401,Chacas,Áncash,Asunción,362,3831,370,4563,0.0810870041639272
20402,Acochaca,Áncash,Asunción,229,2501,85,2815,0.0301953818827709
20501,Chiquian,Áncash,Bolognesi,259,3312,452,4023,0.112353964702958
20502,Abelardo Pardo Lezameta,Áncash,Bolognesi,18,205,21,244,0.0860655737704918
20503,Antonio Raymondi,Áncash,Bolognesi,61,866,67,994,0.0674044265593561
20504,Aquia,Áncash,Bolognesi,178,1668,216,2062,0.104752667313288
20505,Cajacay,Áncash,Bolognesi,138,1393,146,1677,0.0870602265951103
20506,Canis,Áncash,Bolognesi,21,256,35,312,0.112179487179487
20507,Colquioc,Áncash,Bolognesi,156,1871,286,2313,0.123648940769563
20508,Huallanca,Áncash,Bolognesi,576,5266,626,6468,0.0967841682127396
20509,Huasta,Áncash,Bolognesi,117,1217,98,1432,0.0684357541899441
20510,Huayllacayan,Áncash,Bolognesi,81,1132,40,1253,0.0319233838786911
20511,La Primavera,Áncash,Bolognesi,28,422,7,457,0.0153172866520788
20512,Mangas,Áncash,Bolognesi,23,386,83,492,0.16869918699187
20513,Pacllon,Áncash,Bolognesi,64,734,119,917,0.129770992366412
20514,San Miguel de Corpanqui,Áncash,Bolognesi,32,436,27,495,0.0545454545454545
20515,Ticllos,Áncash,Bolognesi,40,547,71,658,0.10790273556231
20601,Carhuaz,Áncash,Carhuaz,1355,12776,991,15122,0.0655336595688401
20602,Acopampa,Áncash,Carhuaz,204,2126,142,2472,0.0574433656957929
20603,Amashca,Áncash,Carhuaz,98,1306,27,1431,0.0188679245283019
20604,Anta,Áncash,Carhuaz,221,2055,89,2365,0.0376321353065539
20605,Ataquero,Áncash,Carhuaz,111,1327,31,1469,0.0211027910142954
20606,Marcara,Áncash,Carhuaz,752,8434,292,9478,0.0308081873813041
20607,Pariahuanca,Áncash,Carhuaz,141,1188,52,1381,0.0376538740043447
20608,San Miguel de Aco,Áncash,Carhuaz,230,2085,35,2350,0.0148936170212766
20609,Shilla,Áncash,Carhuaz,206,2488,95,2789,0.0340623879526712
20610,Tinco,Áncash,Carhuaz,281,2773,281,3335,0.0842578710644678
20611,Yungar,Áncash,Carhuaz,273,2619,100,2992,0.0334224598930481
20701,San Luis,Áncash,Carlos Fermín Fitzcarrald,906,9145,442,10493,0.0421233203087773
20702,San Nicolás,Áncash,Carlos Fermín Fitzcarrald,305,2782,44,3131,0.0140530182050463
20703,Yauya,Áncash,Carlos Fermín Fitzcarrald,390,3602,101,4093,0.0246762765697532
20801,Casma,Áncash,Casma,3193,29357,3215,35765,0.0898923528589403
20802,Buena Vista Alta,Áncash,Casma,477,4049,305,4831,0.0631339267232457
20803,Comandante Noel,Áncash,Casma,188,1763,137,2088,0.0656130268199234
20804,Yautan,Áncash,Casma,849,7013,443,8305,0.0533413606261288
20901,Corongo,Áncash,Corongo,114,1446,117,1677,0.0697674418604651
20902,Aco,Áncash,Corongo,29,327,23,379,0.0606860158311346
20903,Bambas,Áncash,Corongo,56,357,32,445,0.0719101123595506
20904,Cusca,Áncash,Corongo,277,2299,102,2678,0.0380881254667662
20905,La Pampa,Áncash,Corongo,66,799,161,1026,0.15692007797271
20906,Yanac,Áncash,Corongo,52,540,42,634,0.0662460567823344
20907,Yupan,Áncash,Corongo,39,341,313,693,0.451659451659452
21001,Huari,Áncash,Huari,855,7585,738,9178,0.0804096753105252
21002,Anra,Áncash,Huari,95,1225,42,1362,0.0308370044052863
21003,Cajay,Áncash,Huari,249,2265,59,2573,0.0229304314030315
21004,Chavin de Huantar,Áncash,Huari,771,6811,389,7971,0.048801906912558
21005,Huacachi,Áncash,Huari,153,1585,44,1782,0.0246913580246914
21006,Huacchis,Áncash,Huari,109,1236,82,1427,0.0574632095304835
21007,Huachis,Áncash,Huari,349,2856,102,3307,0.0308436649531297
21008,Huantar,Áncash,Huari,216,2296,59,2571,0.0229482691559704
21009,Masin,Áncash,Huari,115,1154,92,1361,0.0675973548861132
21010,Paucas,Áncash,Huari,136,1344,81,1561,0.0518898142216528
21011,Ponto,Áncash,Huari,215,2325,102,2642,0.0386071158213475
21012,Rahuapampa,Áncash,Huari,60,560,85,705,0.120567375886525
21013,Rapayan,Áncash,Huari,105,1241,60,1406,0.042674253200569
21014,San Marcos,Áncash,Huari,1240,12093,3700,17033,0.217225386015382
21015,San Pedro de Chana,Áncash,Huari,329,2091,114,2534,0.0449881610102605
21016,Uco,Áncash,Huari,95,1106,100,1301,0.0768639508070715
21101,Huarmey,Áncash,Huarmey,2257,20335,2525,25117,0.100529521837799
21102,Cochapeti,Áncash,Huarmey,58,678,4,740,0.00540540540540541
21103,Culebras,Áncash,Huarmey,297,2425,375,3097,0.121084920891185
21104,Huayan,Áncash,Huarmey,45,768,48,861,0.0557491289198606
21105,Malvas,Áncash,Huarmey,39,662,44,745,0.0590604026845638
21201,Caraz,Áncash,Huaylas,2236,20178,1714,24128,0.0710377984084881
21202,Huallanca,Áncash,Huaylas,72,739,149,960,0.155208333333333
21203,Huata,Áncash,Huaylas,114,1174,56,1344,0.0416666666666667
21204,Huaylas,Áncash,Huaylas,127,1426,61,1614,0.0377942998760843
21205,Mato,Áncash,Huaylas,174,1578,97,1849,0.0524607896160087
21206,Pamparomas,Áncash,Huaylas,746,6894,164,7804,0.0210148641722194
21207,Pueblo Libre,Áncash,Huaylas,545,5663,163,6371,0.0255846805838958
21208,Santa Cruz,Áncash,Huaylas,361,3776,92,4229,0.0217545519035233
21209,Santo Toribio,Áncash,Huaylas,88,924,43,1055,0.0407582938388626
21210,Yuracmarca,Áncash,Huaylas,222,1676,82,1980,0.0414141414141414
21301,Piscobamba,Áncash,Mariscal Luzuriaga,257,2550,217,3024,0.0717592592592593
21302,Casca,Áncash,Mariscal Luzuriaga,331,3294,43,3668,0.0117230098146129
21303,Eleazar Guzmán Barron,Áncash,Mariscal Luzuriaga,102,1194,30,1326,0.0226244343891403
21304,Fidel Olivas Escudero,Áncash,Mariscal Luzuriaga,185,1700,23,1908,0.0120545073375262
21305,Llama,Áncash,Mariscal Luzuriaga,70,921,29,1020,0.0284313725490196
21306,Llumpa,Áncash,Mariscal Luzuriaga,592,4925,112,5629,0.0198969621602416
21307,Lucma,Áncash,Mariscal Luzuriaga,221,2473,38,2732,0.013909224011713
21308,Musga,Áncash,Mariscal Luzuriaga,70,839,68,977,0.0696008188331627
21401,Ocros,Áncash,Ocros,96,1011,96,1203,0.0798004987531172
21402,Acas,Áncash,Ocros,52,556,48,656,0.0731707317073171
21403,Cajamarquilla,Áncash,Ocros,10,286,4,300,0.0133333333333333
21404,Carhuapampa,Áncash,Ocros,23,418,31,472,0.0656779661016949
21405,Cochas,Áncash,Ocros,138,1114,169,1421,0.118930330752991
21406,Congas,Áncash,Ocros,109,1051,59,1219,0.0484003281378179
21407,Llipa,Áncash,Ocros,15,218,46,279,0.164874551971326
21408,San Cristóbal de Rajan,Áncash,Ocros,24,386,28,438,0.0639269406392694
21409,San Pedro,Áncash,Ocros,48,477,97,622,0.155948553054662
21410,Santiago de Chilcas,Áncash,Ocros,29,299,101,429,0.235431235431235
21501,Cabana,Áncash,Pallasca,257,2012,176,2445,0.0719836400817996
21502,Bolognesi,Áncash,Pallasca,102,834,50,986,0.050709939148073
21503,Conchucos,Áncash,Pallasca,842,6310,239,7391,0.0323366256257611
21504,Huacaschuque,Áncash,Pallasca,58,445,20,523,0.0382409177820268
21505,Huandoval,Áncash,Pallasca,87,851,63,1001,0.0629370629370629
21506,Lacabamba,Áncash,Pallasca,51,426,28,505,0.0554455445544555
21507,Llapo,Áncash,Pallasca,45,494,58,597,0.0971524288107203
21508,Pallasca,Áncash,Pallasca,202,2021,141,2364,0.0596446700507614
21509,Pampas,Áncash,Pallasca,370,3475,135,3980,0.0339195979899498
21510,Santa Rosa,Áncash,Pallasca,79,852,95,1026,0.0925925925925926
21511,Tauca,Áncash,Pallasca,208,2343,122,2673,0.0456416011971568
21601,Pomabamba,Áncash,Pomabamba,1272,11873,689,13834,0.049804828682955
21602,Huayllan,Áncash,Pomabamba,255,2595,104,2954,0.035206499661476
21603,Parobamba,Áncash,Pomabamba,506,5200,100,5806,0.017223561832587
21604,Quinuabamba,Áncash,Pomabamba,186,1993,21,2200,0.00954545454545455
21701,Recuay,Áncash,Recuay,369,3694,343,4406,0.0778483885610531
21702,Catac,Áncash,Recuay,346,3310,251,3907,0.0642436652162785
21703,Cotaparaco,Áncash,Recuay,33,357,19,409,0.0464547677261614
21704,Huayllapampa,Áncash,Recuay,31,561,28,620,0.0451612903225806
21705,Llacllin,Áncash,Recuay,62,791,59,912,0.0646929824561404
21706,Marca,Áncash,Recuay,48,1501,59,1608,0.0366915422885572
21707,Pampas Chico,Áncash,Recuay,64,827,32,923,0.0346695557963164
21708,Pararin,Áncash,Recuay,106,1321,90,1517,0.0593276203032301
21709,Tapacocha,Áncash,Recuay,31,367,23,421,0.0546318289786223
21710,Ticapampa,Áncash,Recuay,240,2024,198,2462,0.0804224207961007
21801,Chimbote,Áncash,Santa,15563,178798,11852,206213,0.0574745530107219
21802,Cáceres del Perú,Áncash,Santa,414,3823,183,4420,0.0414027149321267
21803,Coishco,Áncash,Santa,1408,13597,974,15979,0.0609550034420176
21804,Macate,Áncash,Santa,270,2782,73,3125,0.02336
21805,Moro,Áncash,Santa,776,6853,405,8034,0.0504107542942494
21806,Nepeña,Áncash,Santa,1272,11995,1057,14324,0.0737922368053616
21807,Samanco,Áncash,Santa,452,3900,418,4770,0.0876310272536688
21808,Santa,Áncash,Santa,1754,16542,1325,19621,0.0675296875796341
21809,Nuevo Chimbote,Áncash,Santa,14096,124560,20665,159321,0.129706692777474
21901,Sihuas,Áncash,Sihuas,469,4375,567,5411,0.104786545924968
21902,Acobamba,Áncash,Sihuas,186,1390,36,1612,0.0223325062034739
21903,Alfonso Ugarte,Áncash,Sihuas,31,478,24,533,0.0450281425891182
21904,Cashapampa,Áncash,Sihuas,264,2403,72,2739,0.0262869660460022
21905,Chingalpo,Áncash,Sihuas,91,786,28,905,0.030939226519337
21906,Huayllabamba,Áncash,Sihuas,358,3093,67,3518,0.019044911881751
21907,Quiches,Áncash,Sihuas,184,2080,42,2306,0.018213356461405
21908,Ragash,Áncash,Sihuas,212,2034,32,2278,0.0140474100087796
21909,San Juan,Áncash,Sihuas,666,5463,58,6187,0.00937449490867949
21910,Sicsibamba,Áncash,Sihuas,116,1336,30,1482,0.0202429149797571
22001,Yungay,Áncash,Yungay,1616,17107,1347,20070,0.0671150971599402
22002,Cascapara,Áncash,Yungay,141,1499,34,1674,0.020310633213859
22003,Mancos,Áncash,Yungay,492,5516,328,6336,0.0517676767676768
22004,Matacoto,Áncash,Yungay,117,1169,57,1343,0.0424422933730454
22005,Quillo,Áncash,Yungay,1161,10375,93,11629,0.00799724825866369
22006,Ranrahirca,Áncash,Yungay,193,2330,134,2657,0.0504328189687618
22007,Shupluy,Áncash,Yungay,206,1623,11,1840,0.00597826086956522
22008,Yanama,Áncash,Yungay,489,4714,89,5292,0.0168178382464097
30101,Abancay,Apurímac,Abancay,6159,51277,11592,69028,0.167931853740511
30102,Chacoche,Apurímac,Abancay,115,1081,143,1339,0.106796116504854
30103,Circa,Apurímac,Abancay,111,1657,98,1866,0.052518756698821
30104,Curahuasi,Apurímac,Abancay,1363,13473,1387,16223,0.0854959008814646
30105,Huanipaca,Apurímac,Abancay,198,2619,69,2886,0.0239085239085239
30106,Lambrama,Apurímac,Abancay,181,2605,216,3002,0.0719520319786809
30107,Pichirhua,Apurímac,Abancay,170,2456,148,2774,0.053352559480894
30108,San Pedro de Cachora,Apurímac,Abancay,168,2228,145,2541,0.0570641479732389
30109,Tamburco,Apurímac,Abancay,964,7467,2430,10861,0.223736304207716
30201,Andahuaylas,Apurímac,Andahuaylas,4054,32522,5692,42268,0.134664521623924
30202,Andarapa,Apurímac,Andahuaylas,467,4899,93,5459,0.017036087195457
30203,Chiara,Apurímac,Andahuaylas,90,1026,70,1186,0.0590219224283305
30204,Huancarama,Apurímac,Andahuaylas,372,4511,327,5210,0.062763915547025
30205,Huancaray,Apurímac,Andahuaylas,321,3349,83,3753,0.0221156408206768
30206,Huayana,Apurímac,Andahuaylas,58,668,24,750,0.032
30207,Kishuara,Apurímac,Andahuaylas,621,5179,223,6023,0.0370247385024074
30208,Pacobamba,Apurímac,Andahuaylas,261,3082,109,3452,0.0315758980301275
30209,Pacucha,Apurímac,Andahuaylas,539,7165,285,7989,0.0356740518212542
30210,Pampachiri,Apurímac,Andahuaylas,213,1877,109,2199,0.0495679854479309
30211,Pomacocha,Apurímac,Andahuaylas,75,738,50,863,0.0579374275782155
30212,San Antonio de Cachi,Apurímac,Andahuaylas,256,2581,73,2910,0.025085910652921
30213,San Jerónimo,Apurímac,Andahuaylas,1998,16992,1748,20738,0.0842897097116405
30214,San Miguel de Chaccrampa,Apurímac,Andahuaylas,168,1404,41,1613,0.0254184748915065
30215,Santa María de Chicmo,Apurímac,Andahuaylas,821,7147,184,8152,0.0225711481844946
30216,Talavera,Apurímac,Andahuaylas,1724,15114,1671,18509,0.0902804041277216
30217,Tumay Huaraca,Apurímac,Andahuaylas,175,1670,19,1864,0.0101931330472103
30218,Turpo,Apurímac,Andahuaylas,280,3276,86,3642,0.0236133992311917
30219,Kaquiabamba,Apurímac,Andahuaylas,113,1659,44,1816,0.0242290748898678
30220,José María Arguedas,Apurímac,Andahuaylas,461,3428,192,4081,0.0470472923303112
30301,Antabamba,Apurímac,Antabamba,193,2362,221,2776,0.0796109510086455
30302,El Oro,Apurímac,Antabamba,45,458,49,552,0.088768115942029
30303,Huaquirca,Apurímac,Antabamba,114,1368,359,1841,0.195002715915263
30304,Juan Espinoza Medrano,Apurímac,Antabamba,123,1490,98,1711,0.0572764465225015
30305,Oropesa,Apurímac,Antabamba,202,1954,112,2268,0.0493827160493827
30306,Pachaconas,Apurímac,Antabamba,86,911,57,1054,0.0540796963946869
30307,Sabaino,Apurímac,Antabamba,64,1006,38,1108,0.0342960288808664
30401,Chalhuanca,Apurímac,Aymaraes,410,3334,1184,4928,0.24025974025974
30402,Capaya,Apurímac,Aymaraes,46,486,48,580,0.0827586206896552
30403,Caraybamba,Apurímac,Aymaraes,61,827,41,929,0.0441334768568353
30404,Chapimarca,Apurímac,Aymaraes,145,1612,136,1893,0.0718436344426836
30405,Colcabamba,Apurímac,Aymaraes,51,599,43,693,0.0620490620490621
30406,Cotaruse,Apurímac,Aymaraes,197,2030,343,2570,0.133463035019455
30407,Ihuayllo,Apurímac,Aymaraes,22,386,54,462,0.116883116883117
30408,Justo Apu Sahuaraura,Apurímac,Aymaraes,56,628,51,735,0.0693877551020408
30409,Lucre,Apurímac,Aymaraes,143,1327,59,1529,0.0385873119686069
30410,Pocohuanca,Apurímac,Aymaraes,68,889,65,1022,0.063600782778865
30411,San Juan de Chacña,Apurímac,Aymaraes,52,651,66,769,0.0858257477243173
30412,Sañayca,Apurímac,Aymaraes,70,975,62,1107,0.0560072267389341
30413,Soraya,Apurímac,Aymaraes,49,602,60,711,0.0843881856540084
30414,Tapairihua,Apurímac,Aymaraes,147,1647,54,1848,0.0292207792207792
30415,Tintay,Apurímac,Aymaraes,161,1927,184,2272,0.0809859154929578
30416,Toraya,Apurímac,Aymaraes,82,1099,97,1278,0.0758998435054773
30417,Yanaca,Apurímac,Aymaraes,60,834,87,981,0.0886850152905199
30501,Tambobamba,Apurímac,Cotabambas,1060,8478,843,10381,0.0812060495135343
30502,Cotabambas,Apurímac,Cotabambas,297,3210,379,3886,0.0975295934122491
30503,Coyllurqui,Apurímac,Cotabambas,642,5723,221,6586,0.0335560279380504
30504,Haquira,Apurímac,Cotabambas,733,8086,611,9430,0.0647932131495228
30505,Mara,Apurímac,Cotabambas,546,5076,226,5848,0.0386456908344733
30506,Challhuahuacho,Apurímac,Cotabambas,1380,9343,3802,14525,0.261755593803787
30601,Chincheros,Apurímac,Chincheros,528,4178,587,5293,0.110901190251275
30602,Anco_Huallo,Apurímac,Chincheros,993,8367,1028,10388,0.0989603388525221
30603,Cocharcas,Apurímac,Chincheros,158,1493,77,1728,0.0445601851851852
30604,Huaccana,Apurímac,Chincheros,576,5773,285,6634,0.0429605064817606
30605,Ocobamba,Apurímac,Chincheros,636,5887,236,6759,0.0349164077526261
30606,Ongoy,Apurímac,Chincheros,197,2042,105,2344,0.0447952218430034
30607,Uranmarca,Apurímac,Chincheros,264,2295,91,2650,0.0343396226415094
30608,Ranracancha,Apurímac,Chincheros,388,3515,143,4046,0.0353435491843796
30609,Rocchacc,Apurímac,Chincheros,259,2324,106,2689,0.0394198586835255
30610,El Porvenir,Apurímac,Chincheros,163,1493,72,1728,0.0416666666666667
30611,Los Chankas,Apurímac,Chincheros,103,776,109,988,0.110323886639676
30701,Chuquibambilla,Apurímac,Grau,330,4335,358,5023,0.0712721481186542
30702,Curpahuasi,Apurímac,Grau,153,1710,73,1936,0.0377066115702479
30703,Gamarra,Apurímac,Grau,163,2552,67,2782,0.0240833932422717
30704,Huayllati,Apurímac,Grau,117,1222,29,1368,0.0211988304093567
30705,Mamara,Apurímac,Grau,48,752,58,858,0.0675990675990676
30706,Micaela Bastidas,Apurímac,Grau,58,828,49,935,0.0524064171122995
30707,Pataypampa,Apurímac,Grau,57,719,22,798,0.0275689223057644
30708,Progreso,Apurímac,Grau,337,2400,208,2945,0.0706281833616299
30709,San Antonio,Apurímac,Grau,19,232,21,272,0.0772058823529412
30710,Santa Rosa,Apurímac,Grau,32,508,20,560,0.0357142857142857
30711,Turpay,Apurímac,Grau,38,551,39,628,0.0621019108280255
30712,Vilcabamba,Apurímac,Grau,103,880,250,1233,0.202757502027575
30713,Virundo,Apurímac,Grau,49,602,24,675,0.0355555555555556
30714,Curasco,Apurímac,Grau,107,1071,51,1229,0.0414971521562246
40101,Arequipa,Arequipa,Arequipa,2723,38976,13738,55437,0.247812832584736
40102,Alto Selva Alegre,Arequipa,Arequipa,6534,65235,14101,85870,0.164213345755211
40103,Cayma,Arequipa,Arequipa,7389,67982,16564,91935,0.180170772828629
40104,Cerro Colorado,Arequipa,Arequipa,18348,138087,41519,197954,0.209740646816937
40105,Characato,Arequipa,Arequipa,1162,8196,3591,12949,0.277318711869643
40106,Chiguata,Arequipa,Arequipa,254,2232,453,2939,0.154134059203811
40107,Jacobo Hunter,Arequipa,Arequipa,3919,39469,6776,50164,0.135076947611833
40108,La Joya,Arequipa,Arequipa,2958,23678,5383,32019,0.168118929385677
40109,Mariano Melgar,Arequipa,Arequipa,4424,46138,9356,59918,0.156146733869622
40110,Miraflores,Arequipa,Arequipa,4451,44218,11920,60589,0.196735381009754
40111,Mollebaya,Arequipa,Arequipa,488,2834,1434,4756,0.301513877207738
40112,Paucarpata,Arequipa,Arequipa,9667,104951,16728,131346,0.12735827509022
40113,Pocsi,Arequipa,Arequipa,12,390,43,445,0.0966292134831461
40114,Polobaya,Arequipa,Arequipa,43,743,51,837,0.0609318996415771
40115,Quequeña,Arequipa,Arequipa,441,2660,1683,4784,0.351797658862876
40116,Sabandia,Arequipa,Arequipa,325,3338,705,4368,0.161401098901099
40117,Sachaca,Arequipa,Arequipa,1997,17502,4726,24225,0.195087719298246
40118,San Juan de Siguas,Arequipa,Arequipa,45,485,81,611,0.132569558101473
40119,San Juan de Tarucani,Arequipa,Arequipa,80,1206,91,1377,0.0660856935366739
40120,Santa Isabel de Siguas,Arequipa,Arequipa,46,532,104,682,0.152492668621701
40121,Santa Rita de Siguas,Arequipa,Arequipa,666,5078,574,6318,0.0908515352959797
40122,Socabaya,Arequipa,Arequipa,5645,55634,14072,75351,0.186752664198219
40123,Tiabaya,Arequipa,Arequipa,1331,13012,1848,16191,0.114137483787289
40124,Uchumayo,Arequipa,Arequipa,1228,10819,2007,14054,0.14280631848584
40125,Vitor,Arequipa,Arequipa,268,2849,493,3610,0.136565096952909
40126,Yanahuara,Arequipa,Arequipa,1284,17758,6375,25417,0.250816382735964
40127,Yarabamba,Arequipa,Arequipa,91,915,308,1314,0.234398782343988
40128,Yura,Arequipa,Arequipa,3360,21413,8573,33346,0.257092304924129
40129,José Luis Bustamante Y Rivero,Arequipa,Arequipa,5159,60966,15704,81829,0.191912402693422
40201,Camaná,Arequipa,Camaná,839,10348,2180,13367,0.16308820228922
40202,José María Quimper,Arequipa,Camaná,455,3544,642,4641,0.138332255979315
40203,Mariano Nicolás Valcárcel,Arequipa,Camaná,874,3162,2961,6997,0.423181363441475
40204,Mariscal Cáceres,Arequipa,Camaná,491,4690,1014,6195,0.163680387409201
40205,Nicolás de Pierola,Arequipa,Camaná,580,5648,878,7106,0.12355755699409
40206,Ocoña,Arequipa,Camaná,343,3318,510,4171,0.1222728362503
40207,Quilca,Arequipa,Camaná,95,679,169,943,0.179215270413574
40208,Samuel Pastor,Arequipa,Camaná,1400,12134,2416,15950,0.151473354231975
40301,Caravelí,Arequipa,Caravelí,354,2880,1025,4259,0.240666823197934
40302,Acarí,Arequipa,Caravelí,382,3707,834,4923,0.169408897014016
40303,Atico,Arequipa,Caravelí,467,3797,951,5215,0.182358581016299
40304,Atiquipa,Arequipa,Caravelí,39,387,47,473,0.0993657505285412
40305,Bella Unión,Arequipa,Caravelí,232,2460,479,3171,0.151056449069694
40306,Cahuacho,Arequipa,Caravelí,49,508,53,610,0.0868852459016394
40307,Chala,Arequipa,Caravelí,831,5929,2480,9240,0.268398268398268
40308,Chaparra,Arequipa,Caravelí,312,2314,1059,3685,0.287381275440977
40309,Huanuhuanu,Arequipa,Caravelí,298,1886,863,3047,0.283229405973088
40310,Jaqui,Arequipa,Caravelí,137,1207,188,1532,0.122715404699739
40311,Lomas,Arequipa,Caravelí,134,1071,272,1477,0.184157075152336
40312,Quicacha,Arequipa,Caravelí,167,1445,225,1837,0.122482308111051
40313,Yauca,Arequipa,Caravelí,150,1410,317,1877,0.16888652104422
40401,Aplao,Arequipa,Castilla,634,6939,862,8435,0.102193242442205
40402,Andagua,Arequipa,Castilla,65,778,195,1038,0.187861271676301
40403,Ayo,Arequipa,Castilla,7,189,46,242,0.190082644628099
40404,Chachas,Arequipa,Castilla,135,1293,218,1646,0.132442284325638
40405,Chilcaymarca,Arequipa,Castilla,101,771,75,947,0.0791974656810982
40406,Choco,Arequipa,Castilla,48,600,54,702,0.0769230769230769
40407,Huancarqui,Arequipa,Castilla,101,1154,217,1472,0.14741847826087
40408,Machaguay,Arequipa,Castilla,21,411,56,488,0.114754098360656
40409,Orcopampa,Arequipa,Castilla,843,5946,1388,8177,0.169744405038523
40410,Pampacolca,Arequipa,Castilla,145,1710,177,2032,0.0871062992125984
40411,Tipan,Arequipa,Castilla,32,350,50,432,0.115740740740741
40412,Uñon,Arequipa,Castilla,13,136,58,207,0.280193236714976
40413,Uraca,Arequipa,Castilla,479,5053,734,6266,0.117140121289499
40414,Viraco,Arequipa,Castilla,97,1176,272,1545,0.176051779935275
40501,Chivay,Arequipa,Caylloma,545,4463,762,5770,0.132062391681109
40502,Achoma,Arequipa,Caylloma,58,703,80,841,0.0951248513674197
40503,Cabanaconde,Arequipa,Caylloma,135,1742,219,2096,0.104484732824427
40504,Callalli,Arequipa,Caylloma,89,1269,100,1458,0.0685871056241427
40505,Caylloma,Arequipa,Caylloma,196,2740,761,3697,0.20584257506086
40506,Coporaque,Arequipa,Caylloma,82,820,187,1089,0.171717171717172
40507,Huambo,Arequipa,Caylloma,53,558,59,670,0.0880597014925373
40508,Huanca,Arequipa,Caylloma,64,891,55,1010,0.0544554455445545
40509,Ichupampa,Arequipa,Caylloma,36,470,49,555,0.0882882882882883
40510,Lari,Arequipa,Caylloma,70,783,51,904,0.0564159292035398
40511,Lluta,Arequipa,Caylloma,41,625,52,718,0.0724233983286908
40512,Maca,Arequipa,Caylloma,35,598,68,701,0.0970042796005706
40513,Madrigal,Arequipa,Caylloma,38,544,66,648,0.101851851851852
40514,San Antonio de Chuca,Arequipa,Caylloma,77,739,70,886,0.0790067720090294
40515,Sibayo,Arequipa,Caylloma,42,550,77,669,0.115097159940209
40516,Tapay,Arequipa,Caylloma,42,405,325,772,0.420984455958549
40517,Tisco,Arequipa,Caylloma,106,1188,147,1441,0.102012491325468
40518,Tuti,Arequipa,Caylloma,40,552,29,621,0.0466988727858293
40519,Yanque,Arequipa,Caylloma,171,1748,198,2117,0.0935285781766651
40520,Majes,Arequipa,Caylloma,5946,45309,8853,60108,0.147284887203035
40601,Chuquibamba,Arequipa,Condesuyos,256,2594,440,3290,0.133738601823708
40602,Andaray,Arequipa,Condesuyos,25,373,279,677,0.412112259970458
40603,Cayarani,Arequipa,Condesuyos,218,2297,697,3212,0.216998754669988
40604,Chichas,Arequipa,Condesuyos,36,502,137,675,0.202962962962963
40605,Iray,Arequipa,Condesuyos,37,485,73,595,0.122689075630252
40606,Río Grande,Arequipa,Condesuyos,260,2497,506,3263,0.155072019613852
40607,Salamanca,Arequipa,Condesuyos,32,424,22,478,0.0460251046025105
40608,Yanaquihua,Arequipa,Condesuyos,333,2890,705,3928,0.179480651731161
40701,Mollendo,Arequipa,Islay,1755,19401,2917,24073,0.121173098492087
40702,Cocachacra,Arequipa,Islay,606,7020,721,8347,0.086378339523182
40703,Dean Valdivia,Arequipa,Islay,511,5547,796,6854,0.116136562591188
40704,Islay,Arequipa,Islay,483,3860,789,5132,0.153741231488698
40705,Mejia,Arequipa,Islay,71,752,349,1172,0.29778156996587
40706,Punta de Bombón,Arequipa,Islay,446,5393,617,6456,0.0955700123915737
40801,Cotahuasi,Arequipa,La Unión,241,2125,559,2925,0.191111111111111
40802,Alca,Arequipa,La Unión,183,1492,174,1849,0.094104921579232
40803,Charcana,Arequipa,La Unión,63,432,82,577,0.1421143847487
40804,Huaynacotas,Arequipa,La Unión,169,1614,130,1913,0.0679560899111344
40805,Pampamarca,Arequipa,La Unión,93,984,45,1122,0.0401069518716578
40806,Puyca,Arequipa,La Unión,242,2020,80,2342,0.0341588385994876
40807,Quechualla,Arequipa,La Unión,14,216,35,265,0.132075471698113
40808,Sayla,Arequipa,La Unión,28,257,34,319,0.106583072100313
40809,Tauria,Arequipa,La Unión,32,221,48,301,0.159468438538206
40810,Tomepampa,Arequipa,La Unión,50,564,44,658,0.0668693009118541
40811,Toro,Arequipa,La Unión,33,490,33,556,0.0593525179856115
50101,Ayacucho,Ayacucho,Huamanga,8381,77289,13757,99427,0.138362818952598
50102,Acocro,Ayacucho,Huamanga,888,6335,180,7403,0.0243144671079292
50103,Acos Vinchos,Ayacucho,Huamanga,458,3857,68,4383,0.0155144877937486
50104,Carmen Alto,Ayacucho,Huamanga,2840,20033,5379,28252,0.190393600453065
50105,Chiara,Ayacucho,Huamanga,610,4854,234,5698,0.0410670410670411
50106,Ocros,Ayacucho,Huamanga,454,4764,155,5373,0.0288479434208077
50107,Pacaycasa,Ayacucho,Huamanga,303,2629,182,3114,0.0584457289659602
50108,Quinua,Ayacucho,Huamanga,400,4481,202,5083,0.0397403108400551
50109,San José de Ticllas,Ayacucho,Huamanga,126,1257,20,1403,0.0142551674982181
50110,San Juan Bautista,Ayacucho,Huamanga,4477,36174,8383,49034,0.170963005261655
50111,Santiago de Pischa,Ayacucho,Huamanga,103,1279,45,1427,0.0315346881569727
50112,Socos,Ayacucho,Huamanga,525,5303,124,5952,0.0208333333333333
50113,Tambillo,Ayacucho,Huamanga,589,4236,222,5047,0.0439865266494947
50114,Vinchos,Ayacucho,Huamanga,1335,12116,183,13634,0.0134223265365997
50115,Jesús Nazareno,Ayacucho,Huamanga,1593,13528,3371,18492,0.182295046506597
50116,Andrés Avelino Cáceres Dorregaray,Ayacucho,Huamanga,2263,19186,7023,28472,0.246663388592301
50201,Cangallo,Ayacucho,Cangallo,438,4701,340,5479,0.0620551195473627
50202,Chuschi,Ayacucho,Cangallo,701,6910,710,8321,0.0853262828986901
50203,Los Morochucos,Ayacucho,Cangallo,702,6486,275,7463,0.0368484523650007
50204,María Parado de Bellido,Ayacucho,Cangallo,163,1849,55,2067,0.0266086115142719
50205,Paras,Ayacucho,Cangallo,392,3596,116,4104,0.0282651072124756
50206,Totos,Ayacucho,Cangallo,234,2702,73,3009,0.0242605516782984
50301,Sancos,Ayacucho,Huanca Sancos,223,2553,426,3202,0.133041848844472
50302,Carapo,Ayacucho,Huanca Sancos,101,1645,80,1826,0.0438116100766703
50303,Sacsamarca,Ayacucho,Huanca Sancos,80,1193,40,1313,0.0304645849200305
50304,Santiago de Lucanamarca,Ayacucho,Huanca Sancos,165,1852,51,2068,0.0246615087040619
50401,Huanta,Ayacucho,Huanta,3475,31613,4429,39517,0.112078346028292
50402,Ayahuanco,Ayacucho,Huanta,100,1049,47,1196,0.0392976588628763
50403,Huamanguilla,Ayacucho,Huanta,281,3685,196,4162,0.0470927438731379
50404,Iguain,Ayacucho,Huanta,225,2313,129,2667,0.0483689538807649
50405,Luricocha,Ayacucho,Huanta,443,4700,347,5490,0.0632058287795993
50406,Santillana,Ayacucho,Huanta,340,3369,143,3852,0.0371235721703011
50407,Sivia,Ayacucho,Huanta,1150,8824,823,10797,0.0762248772807261
50408,Llochegua,Ayacucho,Huanta,1209,7463,1386,10058,0.137800755617419
50409,Canayre,Ayacucho,Huanta,446,2498,576,3520,0.163636363636364
50410,Uchuraccay,Ayacucho,Huanta,416,3021,85,3522,0.0241340147643384
50411,Pucacolpa,Ayacucho,Huanta,279,2125,119,2523,0.0471660721363456
50412,Chaca,Ayacucho,Huanta,237,259,1666,2162,0.770582793709528
50501,San Miguel,Ayacucho,La Mar,822,8883,621,10326,0.0601394538059268
50502,Anco,Ayacucho,La Mar,711,6806,452,7969,0.0567197891830845
50503,Ayna,Ayacucho,La Mar,751,7559,988,9298,0.106259410625941
50504,Chilcas,Ayacucho,La Mar,125,1474,44,1643,0.0267802799756543
50505,Chungui,Ayacucho,La Mar,424,3661,133,4218,0.0315315315315315
50506,Luis Carranza,Ayacucho,La Mar,118,1144,16,1278,0.0125195618153365
50507,Santa Rosa,Ayacucho,La Mar,1264,9025,990,11279,0.0877737388066318
50508,Tambo,Ayacucho,La Mar,1035,8830,308,10173,0.0302762213702939
50509,Samugari,Ayacucho,La Mar,990,7687,733,9410,0.0778958554729012
50510,Anchihuay,Ayacucho,La Mar,459,140,3440,4039,0.851695964347611
50511,Oronccoy,Ayacucho,La Mar,94,892,34,1020,0.0333333333333333
50601,Puquio,Ayacucho,Lucanas,1240,11089,1590,13919,0.114232344277606
50602,Aucara,Ayacucho,Lucanas,146,2563,194,2903,0.0668274199104375
50603,Cabana,Ayacucho,Lucanas,113,1825,251,2189,0.11466423024212
50604,Carmen Salcedo,Ayacucho,Lucanas,126,1337,218,1681,0.129684711481261
50605,Chaviña,Ayacucho,Lucanas,151,1785,227,2163,0.104946833102173
50606,Chipao,Ayacucho,Lucanas,175,2208,171,2554,0.0669537979639781
50607,Huac-Huas,Ayacucho,Lucanas,108,1387,65,1560,0.0416666666666667
50608,Laramate,Ayacucho,Lucanas,119,1361,97,1577,0.0615091946734306
50609,Leoncio Prado,Ayacucho,Lucanas,65,996,33,1094,0.030164533820841
50610,Llauta,Ayacucho,Lucanas,53,766,74,893,0.0828667413213886
50611,Lucanas,Ayacucho,Lucanas,211,2314,201,2726,0.0737344093910492
50612,Ocaña,Ayacucho,Lucanas,155,1829,307,2291,0.134002618943693
50613,Otoca,Ayacucho,Lucanas,155,1475,236,1866,0.126473740621651
50614,Saisa,Ayacucho,Lucanas,54,556,181,791,0.228824273072061
50615,San Cristobal,Ayacucho,Lucanas,170,1515,33,1718,0.0192083818393481
50616,San Juan,Ayacucho,Lucanas,55,863,49,967,0.0506721820062048
50617,San Pedro,Ayacucho,Lucanas,249,2330,74,2653,0.027892951375801
50618,San Pedro de Palco,Ayacucho,Lucanas,56,824,47,927,0.0507011866235167
50619,Sancos,Ayacucho,Lucanas,401,3586,791,4778,0.165550439514441
50620,Santa Ana de HuaycAHUACHO,Ayacucho,Lucanas,40,705,51,796,0.064070351758794
50621,Santa Lucia,Ayacucho,Lucanas,99,874,309,1282,0.241029641185647
50701,Coracora,Ayacucho,Parinacochas,988,11019,1117,13124,0.0851112465711673
50702,Chumpi,Ayacucho,Parinacochas,178,1846,162,2186,0.0741079597438243
50703,Coronel Castañeda,Ayacucho,Parinacochas,59,1176,487,1722,0.28281068524971
50704,Pacapausa,Ayacucho,Parinacochas,33,541,56,630,0.0888888888888889
50705,Pullo,Ayacucho,Parinacochas,629,4260,1382,6271,0.220379524796683
50706,Puyusca,Ayacucho,Parinacochas,164,1791,107,2062,0.0518913676042677
50707,San Francisco de Ravacayco,Ayacucho,Parinacochas,44,414,58,516,0.112403100775194
50708,Upahuacho,Ayacucho,Parinacochas,101,981,66,1148,0.0574912891986063
50801,Pausa,Ayacucho,Páucar del Sara Sara,254,2465,512,3231,0.158464871556794
50802,Colta,Ayacucho,Páucar del Sara Sara,33,374,61,468,0.13034188034188
50803,Corculla,Ayacucho,Páucar del Sara Sara,35,368,42,445,0.0943820224719101
50804,Lampa,Ayacucho,Páucar del Sara Sara,148,1691,114,1953,0.0583717357910906
50805,Marcabamba,Ayacucho,Páucar del Sara Sara,38,492,83,613,0.135399673735726
50806,Oyolo,Ayacucho,Páucar del Sara Sara,99,920,434,1453,0.298692360633173
50807,Pararca,Ayacucho,Páucar del Sara Sara,35,346,38,419,0.0906921241050119
50808,San Javier de Alpabamba,Ayacucho,Páucar del Sara Sara,24,235,33,292,0.113013698630137
50809,San José de Ushua,Ayacucho,Páucar del Sara Sara,16,167,38,221,0.171945701357466
50810,Sara Sara,Ayacucho,Páucar del Sara Sara,29,453,32,514,0.0622568093385214
50901,Querobamba,Ayacucho,Sucre,192,2074,304,2570,0.118287937743191
50902,Belén,Ayacucho,Sucre,21,284,24,329,0.0729483282674772
50903,Chalcos,Ayacucho,Sucre,36,398,44,478,0.0920502092050209
50904,Chilcayoc,Ayacucho,Sucre,44,411,41,496,0.0826612903225806
50905,Huacaña,Ayacucho,Sucre,24,325,25,374,0.0668449197860963
50906,Morcolla,Ayacucho,Sucre,85,1103,52,1240,0.0419354838709678
50907,Paico,Ayacucho,Sucre,30,455,68,553,0.122965641952984
50908,San Pedro de Larcay,Ayacucho,Sucre,74,686,48,808,0.0594059405940594
50909,San Salvador de Quije,Ayacucho,Sucre,71,870,37,978,0.0378323108384458
50910,Santiago de Paucaray,Ayacucho,Sucre,33,498,63,594,0.106060606060606
50911,Soras,Ayacucho,Sucre,81,830,114,1025,0.111219512195122
51001,Huancapi,Ayacucho,Víctor Fajardo,134,1547,206,1887,0.109167991520933
51002,Alcamenca,Ayacucho,Víctor Fajardo,117,1377,32,1526,0.0209698558322412
51003,Apongo,Ayacucho,Víctor Fajardo,53,556,21,630,0.0333333333333333
51004,Asquipata,Ayacucho,Víctor Fajardo,16,374,70,460,0.152173913043478
51005,Canaria,Ayacucho,Víctor Fajardo,249,3319,409,3977,0.102841337691727
51006,Cayara,Ayacucho,Víctor Fajardo,60,1044,34,1138,0.0298769771528998
51007,Colca,Ayacucho,Víctor Fajardo,80,878,53,1011,0.0524233432245302
51008,Huamanquiquia,Ayacucho,Víctor Fajardo,117,925,47,1089,0.0431588613406795
51009,Huancaraylla,Ayacucho,Víctor Fajardo,100,1098,96,1294,0.0741885625965997
51010,Hualla,Ayacucho,Víctor Fajardo,134,1808,150,2092,0.0717017208413002
51011,Sarhua,Ayacucho,Víctor Fajardo,201,2344,71,2616,0.0271406727828746
51012,Vilcanchos,Ayacucho,Víctor Fajardo,185,2128,76,2389,0.0318124738384261
51101,Vilcas Huamán,Ayacucho,Vilcas Huamán,508,5571,291,6370,0.0456828885400314
51102,Accomarca,Ayacucho,Vilcas Huamán,60,789,37,886,0.0417607223476298
51103,Carhuanca,Ayacucho,Vilcas Huamán,56,729,34,819,0.0415140415140415
51104,Concepción,Ayacucho,Vilcas Huamán,122,1402,53,1577,0.0336081166772353
51105,Huambalpa,Ayacucho,Vilcas Huamán,73,1218,49,1340,0.0365671641791045
51106,Independencia,Ayacucho,Vilcas Huamán,61,1000,44,1105,0.0398190045248869
51107,Saurama,Ayacucho,Vilcas Huamán,73,943,22,1038,0.0211946050096339
51108,Vischongo,Ayacucho,Vilcas Huamán,324,3230,172,3726,0.0461621041331186
60101,Cajamarca,Cajamarca,Cajamarca,19734,178607,20400,218741,0.0932609798803151
60102,Asunción,Cajamarca,Cajamarca,745,7021,173,7939,0.021791157576521
60103,Chetilla,Cajamarca,Cajamarca,423,3180,57,3660,0.0155737704918033
60104,Cospan,Cajamarca,Cajamarca,689,5984,87,6760,0.0128698224852071
60105,Encañada,Cajamarca,Cajamarca,1853,17085,237,19175,0.0123598435462842
60106,Jesús,Cajamarca,Cajamarca,1618,12858,544,15020,0.0362183754993342
60107,Llacanora,Cajamarca,Cajamarca,616,4724,299,5639,0.0530235857421529
60108,Los Baños del Inca,Cajamarca,Cajamarca,4832,36219,5098,46149,0.110468265834579
60109,Magdalena,Cajamarca,Cajamarca,739,7126,406,8271,0.0490871720469109
60110,Matara,Cajamarca,Cajamarca,285,3045,139,3469,0.0400691842029403
60111,Namora,Cajamarca,Cajamarca,1095,7971,201,9267,0.0216898672709615
60112,San Juan,Cajamarca,Cajamarca,418,3784,141,4343,0.0324660373014046
60201,Cajabamba,Cajamarca,Cajabamba,3026,25764,2432,31222,0.0778937928383832
60202,Cachachi,Cajamarca,Cajabamba,2896,19848,780,23524,0.0331576262540384
60203,Condebamba,Cajamarca,Cajabamba,1385,11667,354,13406,0.026406086826794
60204,Sitacocha,Cajamarca,Cajabamba,944,6441,150,7535,0.019907100199071
60301,Celendín,Cajamarca,Celendín,2442,21094,3389,26925,0.125868152274838
60302,Chumuch,Cajamarca,Celendín,244,2311,45,2600,0.0173076923076923
60303,Cortegana,Cajamarca,Celendín,767,5898,81,6746,0.0120071153276015
60304,Huasmin,Cajamarca,Celendín,928,9615,114,10657,0.0106971943323637
60305,Jorge Chávez,Cajamarca,Celendín,28,391,22,441,0.0498866213151927
60306,José Galvez,Cajamarca,Celendín,229,2158,171,2558,0.0668491008600469
60307,Miguel Iglesias,Cajamarca,Celendín,354,3422,94,3870,0.0242894056847545
60308,Oxamarca,Cajamarca,Celendín,551,4771,72,5394,0.0133481646273637
60309,Sorochuco,Cajamarca,Celendín,608,6681,63,7352,0.00856909684439608
60310,Sucre,Cajamarca,Celendín,491,4334,230,5055,0.0454995054401583
60311,Utco,Cajamarca,Celendín,78,956,18,1052,0.0171102661596958
60312,La Libertad de Pallan,Cajamarca,Celendín,617,5733,84,6434,0.0130556419023935
60401,Chota,Cajamarca,Chota,4056,40128,3095,47279,0.0654624674802767
60402,Anguia,Cajamarca,Chota,272,2824,115,3211,0.0358143880411087
60403,Chadin,Cajamarca,Chota,358,3006,85,3449,0.0246448245868368
60404,Chiguirip,Cajamarca,Chota,297,3265,79,3641,0.0216973358967317
60405,Chimban,Cajamarca,Chota,222,1903,74,2199,0.0336516598453843
60406,Choropampa,Cajamarca,Chota,221,2060,55,2336,0.0235445205479452
60407,Cochabamba,Cajamarca,Chota,429,4932,185,5546,0.0333573746844573
60408,Conchan,Cajamarca,Chota,506,4968,169,5643,0.0299486088959773
60409,Huambos,Cajamarca,Chota,655,7115,202,7972,0.0253386853988961
60410,Lajas,Cajamarca,Chota,829,10016,248,11093,0.0223564409988281
60411,Llama,Cajamarca,Chota,584,6226,265,7075,0.0374558303886926
60412,Miracosta,Cajamarca,Chota,306,2821,76,3203,0.0237277552294724
60413,Paccha,Cajamarca,Chota,395,3893,157,4445,0.0353205849268841
60414,Pion,Cajamarca,Chota,119,1046,49,1214,0.0403624382207578
60415,Querocoto,Cajamarca,Chota,710,7038,275,8023,0.0342764551913249
60416,San Juan de Licupis,Cajamarca,Chota,82,850,26,958,0.0271398747390397
60417,Tacabamba,Cajamarca,Chota,1251,14119,334,15704,0.021268466632705
60418,Tocmoche,Cajamarca,Chota,74,762,23,859,0.0267753201396973
60419,Chalamarca,Cajamarca,Chota,734,8263,137,9134,0.0149989051894022
60501,Contumazá,Cajamarca,Contumazá,708,6451,302,7461,0.0404771478354108
60502,Chilete,Cajamarca,Contumazá,193,2148,294,2635,0.11157495256167
60503,Cupisnique,Cajamarca,Contumazá,112,1184,42,1338,0.031390134529148
60504,Guzmango,Cajamarca,Contumazá,234,2401,44,2679,0.0164240388204554
60505,San Benito,Cajamarca,Contumazá,273,2993,133,3399,0.03912915563401
60506,Santa Cruz de Toled,Cajamarca,Contumazá,94,877,23,994,0.0231388329979879
60507,Tantarica,Cajamarca,Contumazá,190,2168,103,2461,0.0418529053230394
60508,Yonan,Cajamarca,Contumazá,503,5823,400,6726,0.0594707106749926
60601,Cutervo,Cajamarca,Cutervo,4167,44514,2224,50905,0.0436892250270111
60602,Callayuc,Cajamarca,Cutervo,887,8143,331,9361,0.0353594701420788
60603,Choros,Cajamarca,Cutervo,253,2526,99,2878,0.0343988881167477
60604,Cujillo,Cajamarca,Cutervo,216,2052,62,2330,0.0266094420600858
60605,La Ramada,Cajamarca,Cutervo,300,3260,92,3652,0.0251916757940854
60606,Pimpingos,Cajamarca,Cutervo,459,4464,177,5100,0.0347058823529412
60607,Querocotillo,Cajamarca,Cutervo,1194,11600,193,12987,0.0148610148610149
60608,San Andrés de Cutervo,Cajamarca,Cutervo,310,3760,102,4172,0.0244487056567594
60609,San Juan de Cutervo,Cajamarca,Cutervo,150,1612,96,1858,0.0516684607104413
60610,San Luis de Lucma,Cajamarca,Cutervo,223,2701,76,3000,0.0253333333333333
60611,Santa Cruz,Cajamarca,Cutervo,264,2241,117,2622,0.0446224256292906
60612,Santo Domingo de la Capilla,Cajamarca,Cutervo,372,4223,106,4701,0.0225483939587322
60613,Santo Tomas,Cajamarca,Cutervo,573,6147,268,6988,0.0383514596451059
60614,Socota,Cajamarca,Cutervo,652,8163,239,9054,0.026397172520433
60615,Toribio Casanova,Cajamarca,Cutervo,83,960,72,1115,0.0645739910313901
60701,Bambamarca,Cajamarca,Hualgayoc,4781,54023,1109,59913,0.0185101730843056
60702,Chugur,Cajamarca,Hualgayoc,267,2604,49,2920,0.0167808219178082
60703,Hualgayoc,Cajamarca,Hualgayoc,989,13061,1061,15111,0.0702137515717027
60801,Jaén,Cajamarca,Jaén,8368,74767,11018,94153,0.117022293501004
60802,Bellavista,Cajamarca,Jaén,1409,12990,1048,15447,0.0678448889752055
60803,Chontali,Cajamarca,Jaén,1009,8428,373,9810,0.0380224260958206
60804,Colasay,Cajamarca,Jaén,959,8738,541,10238,0.0528423520218793
60805,Huabal,Cajamarca,Jaén,779,6580,283,7642,0.0370321905260403
60806,Las Pirias,Cajamarca,Jaén,463,3594,218,4275,0.0509941520467836
60807,Pomahuaca,Cajamarca,Jaén,831,7150,363,8344,0.0435043144774688
60808,Pucara,Cajamarca,Jaén,658,5571,605,6834,0.08852794849283
60809,Sallique,Cajamarca,Jaén,801,6077,155,7033,0.0220389591923788
60810,San Felipe,Cajamarca,Jaén,443,4120,130,4693,0.0277008310249307
60811,San José del Alto,Cajamarca,Jaén,678,5793,489,6960,0.0702586206896552
60812,Santa Rosa,Cajamarca,Jaén,842,8749,412,10003,0.0411876437068879
60901,San Ignacio,Cajamarca,San Ignacio,3826,28749,2084,34659,0.0601286823047405
60902,Chirinos,Cajamarca,San Ignacio,1521,12097,974,14592,0.0667489035087719
60903,Huarango,Cajamarca,San Ignacio,1792,15535,685,18012,0.0380302020874972
60904,La Coipa,Cajamarca,San Ignacio,2019,16623,920,19562,0.047029956037215
60905,Namballe,Cajamarca,San Ignacio,1100,7686,312,9098,0.0342932512640141
60906,San José de Lourdes,Cajamarca,San Ignacio,1817,14485,744,17046,0.0436466033086941
60907,Tabaconas,Cajamarca,San Ignacio,2045,15110,496,17651,0.0281003909126962
61001,Pedro Gálvez,Cajamarca,San Marcos,1775,16025,2070,19870,0.10417715148465
61002,Chancay,Cajamarca,San Marcos,290,2626,49,2965,0.0165261382799325
61003,Eduardo Villanueva,Cajamarca,San Marcos,285,2159,220,2664,0.0825825825825826
61004,Gregorio Pita,Cajamarca,San Marcos,400,4637,99,5136,0.0192757009345794
61005,Ichocan,Cajamarca,San Marcos,151,1665,85,1901,0.0447133087848501
61006,José Manuel Quiroz,Cajamarca,San Marcos,318,3169,57,3544,0.0160835214446953
61007,José Sabogal,Cajamarca,San Marcos,1404,10500,119,12023,0.00989769608250853
61101,San Miguel,Cajamarca,San Miguel,1018,11857,557,13432,0.0414681357951161
61102,Bolívar,Cajamarca,San Miguel,93,1141,85,1319,0.064442759666414
61103,Calquis,Cajamarca,San Miguel,341,3697,56,4094,0.0136785539814362
61104,Catilluc,Cajamarca,San Miguel,248,2403,96,2747,0.0349472151437932
61105,El Prado,Cajamarca,San Miguel,112,1477,38,1627,0.0233558696988322
61106,La Florida,Cajamarca,San Miguel,128,1878,159,2165,0.0734411085450347
61107,Llapa,Cajamarca,San Miguel,366,4005,110,4481,0.0245480919437626
61108,Nanchoc,Cajamarca,San Miguel,91,1062,137,1290,0.106201550387597
61109,Niepos,Cajamarca,San Miguel,266,2914,113,3293,0.034315214090495
61110,San Gregorio,Cajamarca,San Miguel,167,1991,71,2229,0.0318528488111261
61111,San Silvestre de Cochan,Cajamarca,San Miguel,248,3318,86,3652,0.0235487404162103
61112,Tongod,Cajamarca,San Miguel,234,2367,87,2688,0.0323660714285714
61113,Unión Agua Blanca,Cajamarca,San Miguel,215,2725,86,3026,0.0284203569068077
61201,San Pablo,Cajamarca,San Pablo,1074,11035,354,12463,0.0284040760651529
61202,San Bernardino,Cajamarca,San Pablo,385,3813,96,4294,0.0223567768979972
61203,San Luis,Cajamarca,San Pablo,79,873,6,958,0.00626304801670146
61204,Tumbaden,Cajamarca,San Pablo,329,2977,81,3387,0.0239149689991143
61301,Santa Cruz,Cajamarca,Santa Cruz,756,7818,652,9226,0.070669846087145
61302,Andabamba,Cajamarca,Santa Cruz,97,1183,57,1337,0.0426327599102468
61303,Catache,Cajamarca,Santa Cruz,727,7208,1023,8958,0.114199598124581
61304,Chancaybaños,Cajamarca,Santa Cruz,287,2998,70,3355,0.0208643815201192
61305,La Esperanza,Cajamarca,Santa Cruz,160,2130,31,2321,0.013356311934511
61306,Ninabamba,Cajamarca,Santa Cruz,128,1915,54,2097,0.0257510729613734
61307,Pulan,Cajamarca,Santa Cruz,303,3482,111,3896,0.0284907597535934
61308,Saucepampa,Cajamarca,Santa Cruz,105,1309,32,1446,0.0221300138312586
61309,Sexi,Cajamarca,Santa Cruz,22,313,90,425,0.211764705882353
61310,Uticyacu,Cajamarca,Santa Cruz,104,1134,21,1259,0.0166799046862589
61311,Yauyucan,Cajamarca,Santa Cruz,214,2510,120,2844,0.0421940928270042
70101,Callao,Prov. Constitucional del Callao,"",33128,363537,54595,451260,0.120983468510393
70102,Bellavista,Prov. Constitucional del Callao,"",4148,59044,11659,74851,0.15576278206036
70103,Carmen de la Legua Reynoso,Prov. Constitucional del Callao,"",2897,34161,5182,42240,0.122679924242424
70104,La Perla,Prov. Constitucional del Callao,"",3431,47753,10233,61417,0.166615106566586
70105,La Punta,Prov. Constitucional del Callao,"",153,3025,651,3829,0.170018281535649
70106,Ventanilla,Prov. Constitucional del Callao,"",30662,241673,43265,315600,0.137088086185044
70107,Mi Perú,Prov. Constitucional del Callao,"",4391,35248,5658,45297,0.124908934366514
80101,Cusco,Cusco,Cusco,8577,82371,23682,114630,0.206595132164355
80102,Ccorca,Cusco,Cusco,186,2018,42,2246,0.018699910952805
80103,Poroy,Cusco,Cusco,252,1678,506,2436,0.207717569786535
80104,San Jerónimo,Cusco,Cusco,4999,36575,15501,57075,0.271590013140604
80105,San Sebastian,Cusco,Cusco,9947,73906,28683,112536,0.254878438899552
80106,Santiago,Cusco,Cusco,8388,70606,15762,94756,0.16634302840981
80107,Saylla,Cusco,Cusco,594,2897,1877,5368,0.349664679582712
80108,Wanchaq,Cusco,Cusco,3857,40378,14306,58541,0.244375736663193
80201,Acomayo,Cusco,Acomayo,367,3881,284,4532,0.0626654898499559
80202,Acopia,Cusco,Acomayo,162,2386,102,2650,0.0384905660377358
80203,Acos,Cusco,Acomayo,167,1918,157,2242,0.0700267618198038
80204,Mosoc Llacta,Cusco,Acomayo,79,977,40,1096,0.0364963503649635
80205,Pomacanchi,Cusco,Acomayo,597,6319,290,7206,0.0402442409103525
80206,Rondocan,Cusco,Acomayo,113,1764,61,1938,0.0314757481940145
80207,Sangarara,Cusco,Acomayo,264,2626,386,3276,0.117826617826618
80301,Anta,Cusco,Anta,2029,17294,2351,21674,0.108470979053244
80302,Ancahuasi,Cusco,Anta,600,5782,402,6784,0.0592570754716981
80303,Cachimayo,Cusco,Anta,195,1749,438,2382,0.183879093198992
80304,Chinchaypujio,Cusco,Anta,346,3486,194,4026,0.0481867858917039
80305,Huarocondo,Cusco,Anta,359,3935,239,4533,0.0527244650341937
80306,Limatambo,Cusco,Anta,574,6172,509,7255,0.070158511371468
80307,Mollepata,Cusco,Anta,272,2471,368,3111,0.11828993892639
80308,Pucyura,Cusco,Anta,279,2364,347,2990,0.116053511705686
80309,Zurite,Cusco,Anta,287,2893,271,3451,0.0785279629093017
80401,Calca,Cusco,Calca,1858,15987,2783,20628,0.134913709521039
80402,Coya,Cusco,Calca,259,2922,262,3443,0.0760964275341272
80403,Lamay,Cusco,Calca,462,4508,343,5313,0.0645586297760211
80404,Lares,Cusco,Calca,526,5045,182,5753,0.0316356683469494
80405,Pisac,Cusco,Calca,823,8276,785,9884,0.0794212869283691
80406,San Salvador,Cusco,Calca,477,4525,230,5232,0.043960244648318
80407,Taray,Cusco,Calca,375,3723,214,4312,0.0496289424860853
80408,Yanatile,Cusco,Calca,759,7459,372,8590,0.0433061699650757
80501,Yanaoca,Cusco,Canas,626,7664,369,8659,0.0426146206259383
80502,Checca,Cusco,Canas,395,4548,42,4985,0.00842527582748245
80503,Kunturkanki,Cusco,Canas,375,4239,133,4747,0.0280176953865599
80504,Langui,Cusco,Canas,139,1767,78,1984,0.0393145161290323
80505,Layo,Cusco,Canas,450,4591,130,5171,0.0251402049893638
80506,Pampamarca,Cusco,Canas,102,1628,108,1838,0.058759521218716
80507,Quehue,Cusco,Canas,200,2340,37,2577,0.0143577803647652
80508,Tupac Amaru,Cusco,Canas,165,2298,60,2523,0.0237812128418549
80601,Sicuani,Cusco,Canchis,4819,47199,5809,57827,0.100454804848946
80602,Checacupe,Cusco,Canchis,367,4118,235,4720,0.0497881355932203
80603,Combapata,Cusco,Canchis,409,3867,311,4587,0.0678003052103772
80604,Marangani,Cusco,Canchis,670,8592,338,9600,0.0352083333333333
80605,Pitumarca,Cusco,Canchis,699,6101,370,7170,0.0516039051603905
80606,San Pablo,Cusco,Canchis,256,3778,190,4224,0.0449810606060606
80607,San Pedro,Cusco,Canchis,157,2182,278,2617,0.106228505922812
80608,Tinta,Cusco,Canchis,369,4242,418,5029,0.0831179160866972
80701,Santo Tomas,Cusco,Chumbivilcas,1860,18335,1533,21728,0.0705541237113402
80702,Capacmarca,Cusco,Chumbivilcas,244,3517,105,3866,0.0271598551474392
80703,Chamaca,Cusco,Chumbivilcas,437,5491,316,6244,0.0506085842408712
80704,Colquemarca,Cusco,Chumbivilcas,512,6117,268,6897,0.0388574742641728
80705,Livitaca,Cusco,Chumbivilcas,1132,10311,247,11690,0.0211291702309666
80706,Llusco,Cusco,Chumbivilcas,307,3966,95,4368,0.0217490842490842
80707,Quiñota,Cusco,Chumbivilcas,311,3369,106,3786,0.0279978869519282
80708,Velille,Cusco,Chumbivilcas,516,6166,1149,7831,0.146724556250798
80801,Espinar,Cusco,Espinar,3411,25881,5569,34861,0.15974871633057
80802,Condoroma,Cusco,Espinar,71,709,90,870,0.103448275862069
80803,Coporaque,Cusco,Espinar,733,8641,253,9627,0.0262802534538278
80804,Ocoruro,Cusco,Espinar,67,918,34,1019,0.0333660451422964
80805,Pallpata,Cusco,Espinar,488,3947,388,4823,0.0804478540327597
80806,Pichigua,Cusco,Espinar,215,2537,53,2805,0.0188948306595365
80807,Suyckutambo,Cusco,Espinar,130,1474,39,1643,0.0237370663420572
80808,Alto Pichigua,Cusco,Espinar,148,1675,111,1934,0.0573940020682523
80901,Santa Ana,Cusco,La Convención,1295,25236,1468,27999,0.0524304439444266
80902,Echarate,Cusco,La Convención,1753,19633,1828,23214,0.0787455845610408
80903,Huayopata,Cusco,La Convención,319,4087,367,4773,0.0768908443327048
80904,Maranura,Cusco,La Convención,235,3641,258,4134,0.0624092888243832
80905,Ocobamba,Cusco,La Convención,350,3800,177,4327,0.0409059394499653
80906,Quellouno,Cusco,La Convención,957,12088,266,13311,0.0199834723161295
80907,Kimbiri,Cusco,La Convención,1754,12735,1473,15962,0.092281668963789
80908,Santa Teresa,Cusco,La Convención,448,5035,489,5972,0.0818821165438714
80909,Vilcabamba,Cusco,La Convención,658,8617,282,9557,0.0295071675211887
80910,Pichari,Cusco,La Convención,2351,15610,4730,22691,0.208452690494028
80911,Inkawasi,Cusco,La Convención,422,3639,224,4285,0.0522753792298717
80912,Villa Virgen,Cusco,La Convención,186,1498,296,1980,0.149494949494949
80913,Villa Kintiarina,Cusco,La Convención,263,1593,118,1974,0.0597771023302938
80914,Megantoni,Cusco,La Convención,706,4948,1315,6969,0.18869278232171
81001,Paruro,Cusco,Paruro,240,2549,416,3205,0.129797191887676
81002,Accha,Cusco,Paruro,208,2677,143,3028,0.047225891677675
81003,Ccapi,Cusco,Paruro,180,2850,49,3079,0.0159142578759337
81004,Colcha,Cusco,Paruro,62,868,33,963,0.0342679127725857
81005,Huanoquite,Cusco,Paruro,386,4321,160,4867,0.0328744606533799
81006,Omacha,Cusco,Paruro,524,4845,74,5443,0.013595443689142
81007,Paccaritambo,Cusco,Paruro,102,1805,125,2032,0.0615157480314961
81008,Pillpinto,Cusco,Paruro,49,880,97,1026,0.094541910331384
81009,Yaurisque,Cusco,Paruro,167,1717,40,1924,0.0207900207900208
81101,Paucartambo,Cusco,Paucartambo,1365,10092,414,11871,0.0348749052312358
81102,Caicay,Cusco,Paucartambo,258,2336,122,2716,0.044918998527246
81103,Challabamba,Cusco,Paucartambo,836,7483,114,8433,0.0135183208822483
81104,Colquepata,Cusco,Paucartambo,813,7244,113,8170,0.0138310893512852
81105,Huancarani,Cusco,Paucartambo,719,5961,231,6911,0.0334249746780495
81106,Kosñipata,Cusco,Paucartambo,472,3612,319,4403,0.0724506018623666
81201,Urcos,Cusco,Quispicanchi,963,8746,905,10614,0.0852647446768419
81202,Andahuaylillas,Cusco,Quispicanchi,562,4664,571,5797,0.0984992237364154
81203,Camanti,Cusco,Quispicanchi,229,1610,380,2219,0.171248310049572
81204,Ccarhuayo,Cusco,Quispicanchi,285,2493,85,2863,0.0296891372685994
81205,Ccatca,Cusco,Quispicanchi,1389,11694,212,13295,0.0159458443023693
81206,Cusipata,Cusco,Quispicanchi,356,3713,152,4221,0.0360104240701256
81207,Huaro,Cusco,Quispicanchi,386,3659,460,4505,0.102108768035516
81208,Lucre,Cusco,Quispicanchi,442,3750,414,4606,0.0898827616152844
81209,Marcapata,Cusco,Quispicanchi,429,3750,128,4307,0.0297190619921059
81210,Ocongate,Cusco,Quispicanchi,1560,13264,399,15223,0.0262103396176838
81211,Oropesa,Cusco,Quispicanchi,927,7110,1407,9444,0.148983481575604
81212,Quiquijana,Cusco,Quispicanchi,1113,8895,328,10336,0.031733746130031
81301,Urubamba,Cusco,Urubamba,1778,15688,2616,20082,0.130265909769943
81302,Chinchero,Cusco,Urubamba,1032,8720,725,10477,0.0691991982437721
81303,Huayllabamba,Cusco,Urubamba,484,4462,553,5499,0.100563738861611
81304,Machupicchu,Cusco,Urubamba,371,2934,2042,5347,0.381896390499345
81305,Maras,Cusco,Urubamba,505,5201,240,5946,0.0403632694248234
81306,Ollantaytambo,Cusco,Urubamba,888,8133,1144,10165,0.112543039842597
81307,Yucay,Cusco,Urubamba,306,2426,491,3223,0.152342538008067
90101,Huancavelica,Huancavelica,Huancavelica,3481,31878,4417,39776,0.111046862429606
90102,Acobambilla,Huancavelica,Huancavelica,142,1785,93,2020,0.046039603960396
90103,Acoria,Huancavelica,Huancavelica,1515,16021,264,17800,0.0148314606741573
90104,Conayca,Huancavelica,Huancavelica,55,730,66,851,0.0775558166862515
90105,Cuenca,Huancavelica,Huancavelica,71,1040,26,1137,0.0228671943711522
90106,Huachocolpa,Huancavelica,Huancavelica,165,1549,161,1875,0.0858666666666667
90107,Huayllahuara,Huancavelica,Huancavelica,26,586,25,637,0.0392464678178964
90108,Izcuchaca,Huancavelica,Huancavelica,64,670,112,846,0.132387706855792
90109,Laria,Huancavelica,Huancavelica,45,693,8,746,0.0107238605898123
90110,Manta,Huancavelica,Huancavelica,78,844,31,953,0.0325288562434418
90111,Mariscal Cáceres,Huancavelica,Huancavelica,48,413,48,509,0.0943025540275049
90112,Moya,Huancavelica,Huancavelica,43,847,92,982,0.0936863543788187
90113,Nuevo Occoro,Huancavelica,Huancavelica,122,1515,49,1686,0.0290628706998814
90114,Palca,Huancavelica,Huancavelica,116,1831,58,2005,0.028927680798005
90115,Pilchaca,Huancavelica,Huancavelica,42,430,28,500,0.056
90116,Vilca,Huancavelica,Huancavelica,145,1700,46,1891,0.0243257535695399
90117,Yauli,Huancavelica,Huancavelica,2294,16760,183,19237,0.00951291781462806
90118,Ascensión,Huancavelica,Huancavelica,1256,12284,2026,15566,0.130155467043556
90119,Huando,Huancavelica,Huancavelica,497,5298,242,6037,0.0400861354977638
90201,Acobamba,Huancavelica,Acobamba,805,7360,815,8980,0.0907572383073497
90202,Andabamba,Huancavelica,Acobamba,325,2835,63,3223,0.0195470058951288
90203,Anta,Huancavelica,Acobamba,449,4033,58,4540,0.0127753303964758
90204,Caja,Huancavelica,Acobamba,122,1654,66,1842,0.0358306188925081
90205,Marcas,Huancavelica,Acobamba,104,1325,100,1529,0.065402223675605
90206,Paucara,Huancavelica,Acobamba,1138,8693,584,10415,0.0560729716754681
90207,Pomacocha,Huancavelica,Acobamba,230,2460,139,2829,0.0491339696005656
90208,Rosario,Huancavelica,Acobamba,404,4368,78,4850,0.0160824742268041
90301,Lircay,Huancavelica,Angaraes,2299,19174,1518,22991,0.0660258361967726
90302,Anchonga,Huancavelica,Angaraes,802,6270,43,7115,0.00604356992269852
90303,Callanmarca,Huancavelica,Angaraes,61,546,18,625,0.0288
90304,Ccochaccasa,Huancavelica,Angaraes,388,2410,158,2956,0.0534506089309878
90305,Chincho,Huancavelica,Angaraes,75,816,52,943,0.0551431601272534
90306,Congalla,Huancavelica,Angaraes,330,3094,120,3544,0.0338600451467269
90307,Huanca-Huanca,Huancavelica,Angaraes,151,1136,50,1337,0.037397157816006
90308,Huayllay Grande,Huancavelica,Angaraes,75,987,49,1111,0.0441044104410441
90309,Julcamarca,Huancavelica,Angaraes,146,1365,225,1736,0.129608294930876
90310,San Antonio de Antaparco,Huancavelica,Angaraes,138,2168,17,2323,0.00731812311665949
90311,Santo Tomas de Pata,Huancavelica,Angaraes,122,1286,28,1436,0.0194986072423398
90312,Secclla,Huancavelica,Angaraes,278,2733,79,3090,0.0255663430420712
90401,Castrovirreyna,Huancavelica,Castrovirreyna,300,2446,183,2929,0.0624786616592694
90402,Arma,Huancavelica,Castrovirreyna,63,826,88,977,0.09007164790174
90403,Aurahua,Huancavelica,Castrovirreyna,164,1283,21,1468,0.0143051771117166
90404,Capillas,Huancavelica,Castrovirreyna,65,790,48,903,0.053156146179402
90405,Chupamarca,Huancavelica,Castrovirreyna,84,771,33,888,0.0371621621621622
90406,Cocas,Huancavelica,Castrovirreyna,61,613,29,703,0.0412517780938834
90407,Huachos,Huancavelica,Castrovirreyna,60,794,65,919,0.0707290533188248
90408,Huamatambo,Huancavelica,Castrovirreyna,30,323,35,388,0.0902061855670103
90409,Mollepampa,Huancavelica,Castrovirreyna,95,1014,33,1142,0.0288966725043783
90410,San Juan,Huancavelica,Castrovirreyna,46,561,66,673,0.0980683506686479
90411,Santa Ana,Huancavelica,Castrovirreyna,77,593,193,863,0.223638470451912
90412,Tantara,Huancavelica,Castrovirreyna,66,520,62,648,0.095679012345679
90413,Ticrapo,Huancavelica,Castrovirreyna,127,1180,174,1481,0.117488183659689
90501,Churcampa,Huancavelica,Churcampa,430,4309,349,5088,0.0685927672955975
90502,Anco,Huancavelica,Churcampa,561,4576,231,5368,0.0430327868852459
90503,Chinchihuasi,Huancavelica,Churcampa,185,1721,73,1979,0.0368873168266801
90504,El Carmen,Huancavelica,Churcampa,241,2121,67,2429,0.0275833676410045
90505,La Merced,Huancavelica,Churcampa,86,939,53,1078,0.049165120593692
90506,Locroja,Huancavelica,Churcampa,292,3030,50,3372,0.0148279952550415
90507,Paucarbamba,Huancavelica,Churcampa,408,3764,174,4346,0.0400368154624942
90508,San Miguel de Mayocc,Huancavelica,Churcampa,61,575,109,745,0.146308724832215
90509,San Pedro de Coris,Huancavelica,Churcampa,263,2669,513,3445,0.148911465892598
90510,Pachamarca,Huancavelica,Churcampa,171,1639,46,1856,0.0247844827586207
90511,Cosme,Huancavelica,Churcampa,300,2470,62,2832,0.0218926553672316
90601,Huaytará,Huancavelica,Huaytará,175,1677,294,2146,0.136999068033551
90602,Ayavi,Huancavelica,Huaytará,49,672,24,745,0.0322147651006711
90603,Cordova,Huancavelica,Huaytará,67,818,120,1005,0.119402985074627
90604,Huayacundo Arma,Huancavelica,Huaytará,30,401,17,448,0.0379464285714286
90605,Laramarca,Huancavelica,Huaytará,65,751,29,845,0.0343195266272189
90606,Ocoyo,Huancavelica,Huaytará,57,652,103,812,0.126847290640394
90607,Pilpichaca,Huancavelica,Huaytará,273,2398,87,2758,0.0315445975344453
90608,Querco,Huancavelica,Huaytará,60,932,40,1032,0.0387596899224806
90609,Quito-Arma,Huancavelica,Huaytará,59,596,31,686,0.0451895043731778
90610,San Antonio de Cusicancha,Huancavelica,Huaytará,159,1176,23,1358,0.0169366715758468
90611,San Francisco de Sangayaico,Huancavelica,Huaytará,70,776,74,920,0.0804347826086957
90612,San Isidro,Huancavelica,Huaytará,71,969,14,1054,0.0132827324478178
90613,Santiago de Chocorvos,Huancavelica,Huaytará,119,1497,55,1671,0.0329144225014961
90614,Santiago de Quirahuara,Huancavelica,Huaytará,19,349,8,376,0.0212765957446809
90615,Santo Domingo de Capillas,Huancavelica,Huaytará,63,639,22,724,0.0303867403314917
90616,Tambo,Huancavelica,Huaytará,41,600,26,667,0.0389805097451274
90701,Pampas,Huancavelica,Tayacaja,898,7951,1212,10061,0.120465162508697
90702,Acostambo,Huancavelica,Tayacaja,248,2862,156,3266,0.0477648499693815
90703,Acraquia,Huancavelica,Tayacaja,291,3090,141,3522,0.0400340715502555
90704,Ahuaycha,Huancavelica,Tayacaja,340,3395,138,3873,0.0356312935708753
90705,Colcabamba,Huancavelica,Tayacaja,1041,9515,512,11068,0.0462594868088182
90706,Daniel Hernández,Huancavelica,Tayacaja,845,7234,1010,9089,0.111123335900539
90707,Huachocolpa,Huancavelica,Tayacaja,263,2802,153,3218,0.0475450590428838
90709,Huaribamba,Huancavelica,Tayacaja,225,2709,69,3003,0.022977022977023
90710,Ñahuimpuquio,Huancavelica,Tayacaja,118,1303,59,1480,0.0398648648648649
90711,Pazos,Huancavelica,Tayacaja,466,4557,136,5159,0.026361698003489
90713,Quishuar,Huancavelica,Tayacaja,54,652,25,731,0.0341997264021888
90714,Salcabamba,Huancavelica,Tayacaja,387,3317,124,3828,0.03239289446186
90715,Salcahuasi,Huancavelica,Tayacaja,199,2376,41,2616,0.0156727828746177
90716,San Marcos de Rocchac,Huancavelica,Tayacaja,135,1635,43,1813,0.0237175951461666
90717,Surcubamba,Huancavelica,Tayacaja,389,4021,191,4601,0.0415127146272549
90718,Tintay Puncu,Huancavelica,Tayacaja,307,2479,224,3010,0.0744186046511628
90719,Quichuas,Huancavelica,Tayacaja,447,3331,167,3945,0.0423320659062104
90720,Andaymarca,Huancavelica,Tayacaja,252,1892,229,2373,0.0965023177412558
90721,Roble,Huancavelica,Tayacaja,175,994,131,1300,0.100769230769231
90722,Pichos,Huancavelica,Tayacaja,236,1608,70,1914,0.0365726227795193
90723,Santiago de Tucuma,Huancavelica,Tayacaja,139,1355,39,1533,0.025440313111546
100101,Huánuco,Huánuco,Huánuco,7538,69351,12613,89502,0.14092422515698
100102,Amarilis,Huánuco,Huánuco,7170,61539,12752,81461,0.156541166938781
100103,Chinchao,Huánuco,Huánuco,1268,11475,392,13135,0.0298439284354777
100104,Churubamba,Huánuco,Huánuco,1626,13875,169,15670,0.0107849393746012
100105,Margos,Huánuco,Huánuco,347,3943,74,4364,0.0169569202566453
100106,Quisqui (Kichki),Huánuco,Huánuco,271,3128,54,3453,0.0156385751520417
100107,San Francisco de Cayran,Huánuco,Huánuco,454,3907,427,4788,0.0891812865497076
100108,San Pedro de Chaulan,Huánuco,Huánuco,349,2374,66,2789,0.0236643958408032
100109,Santa Maria del Valle,Huánuco,Huánuco,1764,16665,797,19226,0.0414542806616041
100110,Yarumayo,Huánuco,Huánuco,136,1382,27,1545,0.0174757281553398
100111,Pillco Marca,Huánuco,Huánuco,3824,28690,11304,43818,0.257976174174997
100112,Yacus,Huánuco,Huánuco,389,4893,14,5296,0.00264350453172205
100113,San Pablo de Pillao,Huánuco,Huánuco,908,7227,215,8350,0.025748502994012
100201,Ambo,Huánuco,Ambo,2133,16444,2309,20886,0.110552523221297
100202,Cayna,Huánuco,Ambo,265,2194,43,2502,0.0171862509992006
100203,Colpas,Huánuco,Ambo,183,1514,34,1731,0.0196418255343732
100204,Conchamarca,Huánuco,Ambo,406,3641,394,4441,0.0887187570367034
100205,Huacar,Huánuco,Ambo,615,6618,216,7449,0.0289971808296416
100206,San Francisco,Huánuco,Ambo,147,1360,54,1561,0.0345932094811019
100207,San Rafael,Huánuco,Ambo,901,7737,290,8928,0.0324820788530466
100208,Tomay Kichwa,Huánuco,Ambo,271,2832,279,3382,0.0824955647545831
100301,La Unión,Huánuco,Dos de Mayo,621,5345,668,6634,0.100693397648478
100307,Chuquis,Huánuco,Dos de Mayo,261,3056,47,3364,0.0139714625445898
100311,Marías,Huánuco,Dos de Mayo,631,4816,124,5571,0.0222581224196733
100313,Pachas,Huánuco,Dos de Mayo,477,4799,117,5393,0.0216947895419989
100316,Quivilla,Huánuco,Dos de Mayo,112,989,127,1228,0.103420195439739
100317,Ripan,Huánuco,Dos de Mayo,549,4462,309,5320,0.0580827067669173
100321,Shunqui,Huánuco,Dos de Mayo,148,1513,35,1696,0.0206367924528302
100322,Sillapata,Huánuco,Dos de Mayo,161,1622,31,1814,0.0170893054024256
100323,Yanas,Huánuco,Dos de Mayo,169,2023,46,2238,0.0205540661304736
100401,Huacaybamba,Huánuco,Huacaybamba,594,4954,320,5868,0.05453306066803
100402,Canchabamba,Huánuco,Huacaybamba,274,2392,52,2718,0.0191317144959529
100403,Cochabamba,Huánuco,Huacaybamba,141,1316,119,1576,0.075507614213198
100404,Pinra,Huánuco,Huacaybamba,588,5727,74,6389,0.0115824072624824
100501,Llata,Huánuco,Huamalíes,1221,11308,874,13403,0.0652092815041409
100502,Arancay,Huánuco,Huamalíes,110,1157,89,1356,0.0656342182890855
100503,Chavín de Pariarca,Huánuco,Huamalíes,420,3178,195,3793,0.0514104930134458
100504,Jacas Grande,Huánuco,Huamalíes,572,4908,123,5603,0.0219525254328039
100505,Jircan,Huánuco,Huamalíes,184,1168,60,1412,0.0424929178470255
100506,Miraflores,Huánuco,Huamalíes,342,2710,75,3127,0.0239846498241126
100507,Monzón,Huánuco,Huamalíes,1056,10517,795,12368,0.0642787839586028
100508,Punchao,Huánuco,Huamalíes,193,1746,70,2009,0.0348432055749129
100509,Puños,Huánuco,Huamalíes,402,3598,62,4062,0.0152634170359429
100510,Singa,Huánuco,Huamalíes,273,2744,112,3129,0.0357941834451902
100511,Tantamayo,Huánuco,Huamalíes,177,1543,57,1777,0.032076533483399
100601,Rupa-Rupa,Huánuco,Leoncio Prado,4210,41663,7193,53066,0.13554818527871
100602,Daniel Alomía Robles,Huánuco,Leoncio Prado,625,5111,406,6142,0.0661022468251384
100603,Hermílio Valdizan,Huánuco,Leoncio Prado,367,2891,217,3475,0.0624460431654676
100604,José Crespo y Castillo,Huánuco,Leoncio Prado,2153,17307,2689,22149,0.121405029572441
100605,Luyando,Huánuco,Leoncio Prado,855,6977,1119,8951,0.125013964920121
100606,Mariano Damaso Beraun,Huánuco,Leoncio Prado,1044,8209,795,10048,0.0791202229299363
100607,Pucayacu,Huánuco,Leoncio Prado,405,2430,889,3724,0.238721804511278
100608,Castillo Grande,Huánuco,Leoncio Prado,1289,9345,2934,13568,0.216244103773585
100609,Pueblo Nuevo,Huánuco,Leoncio Prado,401,3363,379,4143,0.091479604151581
100610,Santo Domingo de Anda,Huánuco,Leoncio Prado,255,2055,217,2527,0.0858725761772853
100701,Huacrachuco,Huánuco,Marañón,1458,12233,459,14150,0.0324381625441696
100702,Cholon,Huánuco,Marañón,603,4076,693,5372,0.129002233804914
100703,San Buenaventura,Huánuco,Marañón,254,1816,41,2111,0.0194220748460445
100704,La Morada,Huánuco,Marañón,317,1876,597,2790,0.213978494623656
100705,Santa Rosa de Alto Yanajanca,Huánuco,Marañón,238,1233,728,2199,0.33105957253297
100801,Panao,Huánuco,Pachitea,2009,14846,594,17449,0.0340420654478767
100802,Chaglla,Huánuco,Pachitea,1058,8424,621,10103,0.0614668910224686
100803,Molino,Huánuco,Pachitea,1107,9079,366,10552,0.0346853677028052
100804,Umari,Huánuco,Pachitea,1120,9736,199,11055,0.0180009045680687
100901,Puerto Inca,Huánuco,Puerto Inca,1180,6945,1282,9407,0.136281492505581
100902,Codo del Pozuzo,Huánuco,Puerto Inca,849,5467,785,7101,0.110547810167582
100903,Honoria,Huánuco,Puerto Inca,547,3670,597,4814,0.124013294557541
100904,Tournavista,Huánuco,Puerto Inca,650,3863,934,5447,0.171470534239031
100905,Yuyapichis,Huánuco,Puerto Inca,728,4443,598,5769,0.103657479632519
101001,Jesús,Huánuco,Lauricocha,416,3528,249,4193,0.0593846887669926
101002,Baños,Huánuco,Lauricocha,173,1647,136,1956,0.0695296523517382
101003,Jivia,Huánuco,Lauricocha,82,891,38,1011,0.0375865479723047
101004,Queropalca,Huánuco,Lauricocha,70,921,18,1009,0.0178394449950446
101005,Rondos,Huánuco,Lauricocha,328,3163,104,3595,0.0289290681502086
101006,San Francisco de Asís,Huánuco,Lauricocha,93,1167,36,1296,0.0277777777777778
101007,San Miguel de Cauri,Huánuco,Lauricocha,482,4662,709,5853,0.121134460960191
101101,Chavinillo,Huánuco,Yarowilca,412,4249,128,4789,0.0267279181457507
101102,Cahuac,Huánuco,Yarowilca,97,1041,18,1156,0.0155709342560554
101103,Chacabamba,Huánuco,Yarowilca,117,975,18,1110,0.0162162162162162
101104,Aparicio Pomares,Huánuco,Yarowilca,437,4268,30,4735,0.00633579725448786
101105,Jacas Chico,Huánuco,Yarowilca,98,971,41,1110,0.0369369369369369
101106,Obas,Huánuco,Yarowilca,278,3479,88,3845,0.0228868660598179
101107,Pampamarca,Huánuco,Yarowilca,107,986,35,1128,0.0310283687943262
101108,Choras,Huánuco,Yarowilca,175,1811,38,2024,0.0187747035573123
110101,Ica,Ica,Ica,10987,118305,20988,150280,0.139659302635081
110102,La Tinguiña,Ica,Ica,3807,30456,5311,39574,0.134204275534442
110103,Los Aquijes,Ica,Ica,2202,16705,3056,21963,0.139143104311797
110104,Ocucaje,Ica,Ica,413,3530,449,4392,0.102231329690346
110105,Pachacutec,Ica,Ica,694,5798,919,7411,0.124004857644043
110106,Parcona,Ica,Ica,4831,43645,5571,54047,0.103076951542176
110107,Pueblo Nuevo,Ica,Ica,578,5132,685,6395,0.10711493354183
110108,Salas,Ica,Ica,2876,18185,4706,25767,0.18263670586409
110109,San José de Los Molinos,Ica,Ica,633,5861,493,6987,0.0705596107055961
110110,San Juan Bautista,Ica,Ica,1169,11218,1459,13846,0.1053733930377
110111,Santiago,Ica,Ica,2600,22687,2358,27645,0.0852957135105806
110112,Subtanjalla,Ica,Ica,2778,19272,5337,27387,0.194873480118304
110113,Tate,Ica,Ica,443,3819,447,4709,0.0949246124442557
110114,Yauca del Rosario,Ica,Ica,53,1015,48,1116,0.0430107526881721
110201,Chincha Alta,Ica,Chincha,6282,54610,5457,66349,0.0822469065095179
110202,Alto Laran,Ica,Chincha,865,6048,870,7783,0.111782089168701
110203,Chavin,Ica,Chincha,32,1592,447,2071,0.215837759536456
110204,Chincha Baja,Ica,Chincha,1287,10875,847,13009,0.0651087708509493
110205,El Carmen,Ica,Chincha,1302,10511,556,12369,0.0449510873959091
110206,Grocio Prado,Ica,Chincha,2633,20467,2194,25294,0.0867399383252945
110207,Pueblo Nuevo,Ica,Chincha,6225,49652,6727,62604,0.10745319787873
110208,San Juan de Yanac,Ica,Chincha,88,1039,2,1129,0.00177147918511957
110209,San Pedro de Huacarpana,Ica,Chincha,81,886,25,992,0.0252016129032258
110210,Sunampe,Ica,Chincha,3015,23498,2566,29079,0.0882423742219471
110211,Tambo de Mora,Ica,Chincha,521,4451,462,5434,0.0850202429149798
110301,Nasca,Ica,Nasca,2198,22346,3088,27632,0.111754487550666
110302,Changuillo,Ica,Nasca,160,1634,156,1950,0.08
110303,El Ingenio,Ica,Nasca,276,2619,239,3134,0.0762603701340141
110304,Marcona,Ica,Nasca,1286,11610,3085,15981,0.193041737062762
110305,Vista Alegre,Ica,Nasca,2089,15792,2579,20460,0.126050830889541
110401,Palpa,Ica,Palpa,663,6337,748,7748,0.0965410428497677
110402,Llipata,Ica,Palpa,147,1301,107,1555,0.0688102893890675
110403,Río Grande,Ica,Palpa,227,2250,181,2658,0.0680963130173063
110404,Santa Cruz,Ica,Palpa,74,780,73,927,0.0787486515641856
110405,Tibillo,Ica,Palpa,38,277,29,344,0.0843023255813954
110501,Pisco,Ica,Pisco,6490,55924,5053,67467,0.0748958750203803
110502,Huancano,Ica,Pisco,87,1068,224,1379,0.16243654822335
110503,Humay,Ica,Pisco,511,4566,331,5408,0.0612056213017752
110504,Independencia,Ica,Pisco,1363,10800,824,12987,0.0634480634480635
110505,Paracas,Ica,Pisco,688,4644,1815,7147,0.253952707429691
110506,San Andrés,Ica,Pisco,1301,11249,1217,13767,0.0883997966150941
110507,San Clemente,Ica,Pisco,2702,20135,1977,24814,0.0796727653743854
110508,Tupac Amaru Inca,Ica,Pisco,1886,14127,1762,17775,0.0991279887482419
120101,Huancayo,Junín,Huancayo,9022,91441,19530,119993,0.162759494303834
120104,Carhuacallanga,Junín,Huancayo,22,465,19,506,0.0375494071146245
120105,Chacapampa,Junín,Huancayo,62,841,56,959,0.0583941605839416
120106,Chicche,Junín,Huancayo,46,654,41,741,0.0553306342780027
120107,Chilca,Junín,Huancayo,7988,70179,13684,91851,0.148980413931258
120108,Chongos Alto,Junín,Huancayo,68,1163,253,1484,0.170485175202156
120111,Chupuro,Junín,Huancayo,143,1646,157,1946,0.0806783144912641
120112,Colca,Junín,Huancayo,74,903,40,1017,0.0393313667649951
120113,Cullhuas,Junín,Huancayo,102,1208,25,1335,0.0187265917602996
120114,El Tambo,Junín,Huancayo,12425,128740,25194,166359,0.151443564820659
120116,Huacrapuquio,Junín,Huancayo,112,1108,146,1366,0.10688140556369
120117,Hualhuas,Junín,Huancayo,448,3645,1158,5251,0.220529422967054
120119,Huancan,Junín,Huancayo,2389,17143,5298,24830,0.213370922271446
120120,Huasicancha,Junín,Huancayo,58,736,35,829,0.0422195416164053
120121,Huayucachi,Junín,Huancayo,881,7464,1455,9800,0.148469387755102
120122,Ingenio,Junín,Huancayo,196,2031,149,2376,0.0627104377104377
120124,Pariahuanca,Junín,Huancayo,470,4608,52,5130,0.0101364522417154
120125,Pilcomayo,Junín,Huancayo,1779,13710,4566,20055,0.227673896783844
120126,Pucara,Junín,Huancayo,356,4083,309,4748,0.0650800336983993
120127,Quichuay,Junín,Huancayo,155,1558,139,1852,0.0750539956803456
120128,Quilcas,Junín,Huancayo,350,3184,370,3904,0.0947745901639344
120129,San Agustín,Junín,Huancayo,1443,10717,3121,15281,0.204240560172764
120130,San Jerónimo de Tunan,Junín,Huancayo,1029,8625,1947,11601,0.167830359451771
120132,Saño,Junín,Huancayo,508,4158,846,5512,0.153483309143686
120133,Sapallanga,Junín,Huancayo,2036,14980,4080,21096,0.193401592718999
120134,Sicaya,Junín,Huancayo,1705,12371,2856,16932,0.168674698795181
120135,Santo Domingo de Acobamba,Junín,Huancayo,599,5420,203,6222,0.0326261652201864
120136,Viques,Junín,Huancayo,248,1970,421,2639,0.159530125047366
120201,Concepción,Junín,Concepción,1160,11930,2338,15428,0.151542649727768
120202,Aco,Junín,Concepción,132,1389,121,1642,0.0736906211936663
120203,Andamarca,Junín,Concepción,371,3003,128,3502,0.0365505425471159
120204,Chambara,Junín,Concepción,225,2231,94,2550,0.0368627450980392
120205,Cochas,Junín,Concepción,193,1635,95,1923,0.0494019760790432
120206,Comas,Junín,Concepción,486,4683,208,5377,0.038683280639762
120207,Heroínas Toledo,Junín,Concepción,77,845,50,972,0.051440329218107
120208,Manzanares,Junín,Concepción,126,1202,150,1478,0.10148849797023
120209,Mariscal Castilla,Junín,Concepción,147,1155,92,1394,0.0659971305595409
120210,Matahuasi,Junín,Concepción,476,4373,688,5537,0.124255011739209
120211,Mito,Junín,Concepción,104,1141,137,1382,0.0991316931982634
120212,Nueve de Julio,Junín,Concepción,198,1715,374,2287,0.163533012680367
120213,Orcotuna,Junín,Concepción,466,3810,462,4738,0.0975094976783453
120214,San José de Quero,Junín,Concepción,501,4801,96,5398,0.0177843645794739
120215,Santa Rosa de Ocopa,Junín,Concepción,146,1592,245,1983,0.123550176500252
120301,Chanchamayo,Junín,Chanchamayo,2153,21417,4220,27790,0.151853184598777
120302,Perene,Junín,Chanchamayo,5151,43558,4165,52874,0.0787721753602905
120303,Pichanaqui,Junín,Chanchamayo,3867,31805,3382,39054,0.0865980437343166
120304,San Luis de Shuaro,Junín,Chanchamayo,372,3503,282,4157,0.0678373827279288
120305,San Ramón,Junín,Chanchamayo,2257,20168,3375,25800,0.130813953488372
120306,Vitoc,Junín,Chanchamayo,139,1415,260,1814,0.143329658213892
120401,Jauja,Junín,Jauja,1258,14253,2397,17908,0.133850792941702
120402,Acolla,Junín,Jauja,428,5302,347,6077,0.0571005430311009
120403,Apata,Junín,Jauja,351,3601,332,4284,0.0774976657329599
120404,Ataura,Junín,Jauja,105,1012,147,1264,0.11629746835443
120405,Canchayllo,Junín,Jauja,149,1332,120,1601,0.0749531542785759
120406,Curicaca,Junín,Jauja,140,1158,112,1410,0.0794326241134752
120407,El Mantaro,Junín,Jauja,229,2100,269,2598,0.103541185527329
120408,Huamali,Junín,Jauja,131,1320,195,1646,0.118469015795869
120409,Huaripampa,Junín,Jauja,77,797,126,1000,0.126
120410,Huertas,Junín,Jauja,195,1617,229,2041,0.112199902008819
120411,Janjaillo,Junín,Jauja,35,494,29,558,0.0519713261648746
120412,Julcán,Junín,Jauja,67,612,66,745,0.0885906040268456
120413,Leonor Ordoñez,Junín,Jauja,110,1275,168,1553,0.108177720540889
120414,Llocllapampa,Junín,Jauja,84,972,87,1143,0.0761154855643045
120415,Marco,Junín,Jauja,95,1285,71,1451,0.0489317711922812
120416,Masma,Junín,Jauja,157,1428,147,1732,0.0848729792147806
120417,Masma Chicche,Junín,Jauja,60,648,24,732,0.0327868852459016
120418,Molinos,Junín,Jauja,152,1329,92,1573,0.0584869675778767
120419,Monobamba,Junín,Jauja,140,1295,227,1662,0.136582430806258
120420,Muqui,Junín,Jauja,68,816,133,1017,0.130776794493609
120421,Muquiyauyo,Junín,Jauja,193,1855,287,2335,0.122912205567452
120422,Paca,Junín,Jauja,55,771,66,892,0.0739910313901345
120423,Paccha,Junín,Jauja,127,1263,60,1450,0.0413793103448276
120424,Pancan,Junín,Jauja,89,1015,122,1226,0.099510603588907
120425,Parco,Junín,Jauja,86,956,111,1153,0.0962705984388552
120426,Pomacancha,Junín,Jauja,125,1257,45,1427,0.0315346881569727
120427,Ricran,Junín,Jauja,102,1127,67,1296,0.0516975308641975
120428,San Lorenzo,Junín,Jauja,226,1976,336,2538,0.132387706855792
120429,San Pedro de Chunan,Junín,Jauja,34,617,51,702,0.0726495726495727
120430,Sausa,Junín,Jauja,297,2200,563,3060,0.183986928104575
120431,Sincos,Junín,Jauja,325,3557,174,4056,0.0428994082840237
120432,Tunan Marca,Junín,Jauja,92,863,83,1038,0.0799614643545279
120433,Yauli,Junín,Jauja,78,928,91,1097,0.0829535095715588
120434,Yauyos,Junín,Jauja,775,7071,1146,8992,0.127446619217082
120501,Junín,Junín,Junín,878,9157,941,10976,0.0857325072886297
120502,Carhuamayo,Junín,Junín,536,5512,590,6638,0.0888821934317566
120503,Ondores,Junín,Junín,88,1079,69,1236,0.0558252427184466
120504,Ulcumayo,Junín,Junín,434,3698,151,4283,0.0352556619192155
120601,Satipo,Junín,Satipo,3422,29347,4306,37075,0.116142953472691
120602,Coviriali,Junín,Satipo,641,4648,489,5778,0.0846313603322949
120603,Llaylla,Junín,Satipo,475,5864,205,6544,0.0313264058679707
120604,Mazamari,Junín,Satipo,4895,28102,2722,35719,0.0762059408158123
120605,Pampa Hermosa,Junín,Satipo,377,3153,160,3690,0.043360433604336
120606,Pangoa,Junín,Satipo,6486,44271,3483,54240,0.0642146017699115
120607,Río Negro,Junín,Satipo,5202,23789,1660,30651,0.0541581025088904
120608,Río Tambo,Junín,Satipo,3661,21236,1139,26036,0.0437471193731756
120609,Vizcatan del Ene,Junín,Satipo,511,2678,1063,4252,0.25
120701,Tarma,Junín,Tarma,3815,39265,4695,47775,0.0982731554160125
120702,Acobamba,Junín,Tarma,695,8042,763,9500,0.0803157894736842
120703,Huaricolca,Junín,Tarma,167,1634,98,1899,0.0516061084781464
120704,Huasahuasi,Junín,Tarma,901,8671,329,9901,0.0332289667710332
120705,La Unión,Junín,Tarma,293,2967,254,3514,0.0722822993739328
120706,Palca,Junín,Tarma,455,4846,242,5543,0.0436586685910157
120707,Palcamayo,Junín,Tarma,267,3001,170,3438,0.0494473531122746
120708,San Pedro de Cajas,Junín,Tarma,243,3081,223,3547,0.0628700310121229
120709,Tapo,Junín,Tarma,410,3944,119,4473,0.02660406885759
120801,La Oroya,Junín,Yauli,1073,11650,1298,14021,0.0925754225804151
120802,Chacapalpa,Junín,Yauli,65,574,48,687,0.0698689956331878
120803,Huay-Huay,Junín,Yauli,121,1234,592,1947,0.304057524396507
120804,Marcapomacocha,Junín,Yauli,72,642,121,835,0.144910179640719
120805,Morococha,Junín,Yauli,335,3362,1458,5155,0.282832201745878
120806,Paccha,Junín,Yauli,134,1300,199,1633,0.121861604409063
120807,Santa Bárbara de Carhuacayan,Junín,Yauli,69,694,341,1104,0.308876811594203
120808,Santa Rosa de Sacco,Junín,Yauli,647,7342,988,8977,0.110059039768297
120809,Suitucancha,Junín,Yauli,69,594,27,690,0.0391304347826087
120810,Yauli,Junín,Yauli,320,3313,1708,5341,0.319790301441678
120901,Chupaca,Junín,Chupaca,1691,16630,2020,20341,0.0993068187404749
120902,Ahuac,Junín,Chupaca,507,5327,433,6267,0.0690920695707675
120903,Chongos Bajo,Junín,Chupaca,342,3771,424,4537,0.0934538241128499
120904,Huachac,Junín,Chupaca,230,2395,323,2948,0.109565807327001
120905,Huamancaca Chico,Junín,Chupaca,676,5577,2513,8766,0.286675792835957
120906,San Juan de Iscos,Junín,Chupaca,185,1876,167,2228,0.0749551166965889
120907,San Juan de Jarpa,Junín,Chupaca,207,2414,37,2658,0.0139202407825433
120908,Tres de Diciembre,Junín,Chupaca,267,1702,696,2665,0.261163227016886
120909,Yanacancha,Junín,Chupaca,243,2267,68,2578,0.0263770364623739
130101,Trujillo,La Libertad,Trujillo,21032,254645,39262,314939,0.124665411397128
130102,El Porvenir,La Libertad,Trujillo,19516,150224,20721,190461,0.108793926315624
130103,Florencia de Mora,La Libertad,Trujillo,3120,31056,3086,37262,0.0828189576512265
130104,Huanchaco,La Libertad,Trujillo,6001,47597,14811,68409,0.216506600008771
130105,La Esperanza,La Libertad,Trujillo,17466,151320,20420,189206,0.10792469583417
130106,Laredo,La Libertad,Trujillo,3355,31139,2712,37206,0.0728914691178842
130107,Moche,La Libertad,Trujillo,3429,29467,4540,37436,0.121273640346191
130108,Poroto,La Libertad,Trujillo,329,3074,183,3586,0.051031790295594
130109,Salaverry,La Libertad,Trujillo,1846,13761,3337,18944,0.176150760135135
130110,Simbal,La Libertad,Trujillo,373,3528,160,4061,0.0393991627677912
130111,Victor Larco Herrera,La Libertad,Trujillo,4982,51318,12206,68506,0.178174174524859
130201,Ascope,La Libertad,Ascope,510,5570,382,6462,0.0591148251315382
130202,Chicama,La Libertad,Ascope,1343,12809,1115,15267,0.0730333398834087
130203,Chocope,La Libertad,Ascope,724,7906,691,9321,0.0741336766441369
130204,Magdalena de Cao,La Libertad,Ascope,185,2096,182,2463,0.0738936256597645
130205,Paijan,La Libertad,Ascope,2463,21782,1668,25913,0.0643692355188516
130206,Razuri,La Libertad,Ascope,785,7062,817,8664,0.0942982456140351
130207,Santiago de Cao,La Libertad,Ascope,1502,16522,1180,19204,0.0614455321807957
130208,Casa Grande,La Libertad,Ascope,2272,24749,1471,28492,0.0516285273059104
130301,Bolívar,La Libertad,Bolívar,458,3752,245,4455,0.0549943883277217
130302,Bambamarca,La Libertad,Bolívar,370,2469,69,2908,0.0237276478679505
130303,Condormarca,La Libertad,Bolívar,230,1598,86,1914,0.044932079414838
130304,Longotea,La Libertad,Bolívar,214,1640,244,2098,0.1163012392755
130305,Uchumarca,La Libertad,Bolívar,238,1882,126,2246,0.056099732858415
130306,Ucuncha,La Libertad,Bolívar,95,675,66,836,0.0789473684210526
130401,Chepén,La Libertad,Chepén,3478,39321,2934,45733,0.0641549865523801
130402,Pacanga,La Libertad,Chepén,1888,16812,2356,21056,0.111892097264438
130403,Pueblo Nuevo,La Libertad,Chepén,989,9933,707,11629,0.060796285149196
130501,Julcán,La Libertad,Julcán,1181,10115,209,11505,0.0181660147761843
130502,Calamarca,La Libertad,Julcán,458,4358,50,4866,0.010275380189067
130503,Carabamba,La Libertad,Julcán,731,5422,68,6221,0.0109307185339978
130504,Huaso,La Libertad,Julcán,639,4744,49,5432,0.00902061855670103
130601,Otuzco,La Libertad,Otuzco,2300,21189,680,24169,0.0281352145310108
130602,Agallpampa,La Libertad,Otuzco,1026,8064,162,9252,0.0175097276264591
130604,Charat,La Libertad,Otuzco,209,2129,82,2420,0.0338842975206612
130605,Huaranchal,La Libertad,Otuzco,370,3425,145,3940,0.0368020304568528
130606,La Cuesta,La Libertad,Otuzco,57,530,27,614,0.0439739413680782
130608,Mache,La Libertad,Otuzco,242,2384,67,2693,0.0248793167471222
130610,Paranday,La Libertad,Otuzco,45,466,12,523,0.0229445506692161
130611,Salpo,La Libertad,Otuzco,515,5137,179,5831,0.0306979934831075
130613,Sinsicap,La Libertad,Otuzco,745,6214,73,7032,0.0103811149032992
130614,Usquil,La Libertad,Otuzco,2181,18990,217,21388,0.0101458761922573
130701,San Pedro de Lloc,La Libertad,Pacasmayo,1473,14628,1536,17637,0.0870896410954244
130702,Guadalupe,La Libertad,Pacasmayo,3442,33690,3085,40217,0.0767088544645299
130703,Jequetepeque,La Libertad,Pacasmayo,365,3341,430,4136,0.103965183752418
130704,Pacasmayo,La Libertad,Pacasmayo,2422,23649,2888,28959,0.09972720052488
130705,San José,La Libertad,Pacasmayo,1053,10106,789,11948,0.0660361566789421
130801,Tayabamba,La Libertad,Pataz,1282,10615,593,12490,0.0474779823859087
130802,Buldibuyo,La Libertad,Pataz,389,3020,403,3812,0.105718782791186
130803,Chillia,La Libertad,Pataz,1441,9991,246,11678,0.0210652508991266
130804,Huancaspata,La Libertad,Pataz,607,5154,116,5877,0.019737961545006
130805,Huaylillas,La Libertad,Pataz,99,983,76,1158,0.0656303972366149
130806,Huayo,La Libertad,Pataz,378,2948,152,3478,0.0437032777458309
130807,Ongon,La Libertad,Pataz,126,1093,31,1250,0.0248
130808,Parcoy,La Libertad,Pataz,1680,12484,4566,18730,0.24378003203417
130809,Pataz,La Libertad,Pataz,1107,6228,1602,8937,0.179254783484391
130810,Pias,La Libertad,Pataz,152,1323,181,1656,0.109299516908213
130811,Santiago de Challas,La Libertad,Pataz,173,1988,49,2210,0.0221719457013575
130812,Taurija,La Libertad,Pataz,317,2373,89,2779,0.0320259086002159
130813,Urpay,La Libertad,Pataz,175,1830,43,2048,0.02099609375
130901,Huamachuco,La Libertad,Sánchez Carrión,7800,54222,4880,66902,0.0729425129293594
130902,Chugay,La Libertad,Sánchez Carrión,2153,14273,343,16769,0.0204544099230723
130903,Cochorco,La Libertad,Sánchez Carrión,1118,7067,213,8398,0.0253631817099309
130904,Curgos,La Libertad,Sánchez Carrión,960,6753,109,7822,0.0139350549731526
130905,Marcabal,La Libertad,Sánchez Carrión,1079,9233,119,10431,0.0114083021762055
130906,Sanagoran,La Libertad,Sánchez Carrión,1779,10978,165,12922,0.0127689212196254
130907,Sarin,La Libertad,Sánchez Carrión,1198,7567,151,8916,0.0169358456707044
130908,Sartimbamba,La Libertad,Sánchez Carrión,1566,10467,212,12245,0.0173131890567579
131001,Santiago de Chuco,La Libertad,Santiago de Chuco,1895,15909,507,18311,0.0276882748074928
131002,Angasmarca,La Libertad,Santiago de Chuco,466,4180,164,4810,0.0340956340956341
131003,Cachicadan,La Libertad,Santiago de Chuco,532,4585,202,5319,0.037977063357774
131004,Mollebamba,La Libertad,Santiago de Chuco,173,1499,62,1734,0.0357554786620531
131005,Mollepata,La Libertad,Santiago de Chuco,223,2078,38,2339,0.0162462590850791
131006,Quiruvilca,La Libertad,Santiago de Chuco,1266,9960,1065,12291,0.0866487673907737
131007,Santa Cruz de Chuca,La Libertad,Santiago de Chuco,235,2414,203,2852,0.0711781206171108
131008,Sitabamba,La Libertad,Santiago de Chuco,385,2753,102,3240,0.0314814814814815
131101,Cascas,La Libertad,Gran Chimú,1128,11565,681,13374,0.0509196949304621
131102,Lucma,La Libertad,Gran Chimú,415,4128,182,4725,0.0385185185185185
131103,Marmot,La Libertad,Gran Chimú,207,1906,294,2407,0.122143747403407
131104,Sayapullo,La Libertad,Gran Chimú,710,5437,239,6386,0.0374256185405575
131201,Virú,La Libertad,Virú,5636,41987,4784,52407,0.0912855152937585
131202,Chao,La Libertad,Virú,3979,22803,6060,32842,0.184519822178917
131203,Guadalupito,La Libertad,Virú,764,5772,539,7075,0.0761837455830389
140101,Chiclayo,Lambayeque,Chiclayo,19768,220584,30144,270496,0.111439725541228
140102,Chongoyape,Lambayeque,Chiclayo,1562,15356,1446,18364,0.0787410150294054
140103,Eten,Lambayeque,Chiclayo,1121,9896,976,11993,0.0813808054698574
140104,Eten Puerto,Lambayeque,Chiclayo,150,1932,260,2342,0.111016225448335
140105,José Leonardo Ortiz,Lambayeque,Chiclayo,12590,128839,15069,156498,0.0962887704635203
140106,La Victoria,Lambayeque,Chiclayo,7762,71774,11376,90912,0.125131995776135
140107,Lagunas,Lambayeque,Chiclayo,1002,7912,1072,9986,0.107350290406569
140108,Monsefu,Lambayeque,Chiclayo,2792,27404,2029,32225,0.0629635376260667
140109,Nueva Arica,Lambayeque,Chiclayo,176,2069,213,2458,0.0866558177379984
140110,Oyotun,Lambayeque,Chiclayo,640,6963,598,8201,0.0729179368369711
140111,Picsi,Lambayeque,Chiclayo,733,8721,3250,12704,0.255824937027708
140112,Pimentel,Lambayeque,Chiclayo,4128,31565,8909,44602,0.199744406080445
140113,Reque,Lambayeque,Chiclayo,1421,11952,2371,15744,0.150597052845528
140114,Santa Rosa,Lambayeque,Chiclayo,1335,10300,715,12350,0.0578947368421053
140115,Saña,Lambayeque,Chiclayo,944,9563,1110,11617,0.0955496255487647
140116,Cayalti,Lambayeque,Chiclayo,1181,12754,874,14809,0.0590181646296171
140117,Patapo,Lambayeque,Chiclayo,1985,19148,1491,22624,0.0659034653465347
140118,Pomalca,Lambayeque,Chiclayo,2141,21356,1770,25267,0.0700518462817113
140119,Pucala,Lambayeque,Chiclayo,679,7335,687,8701,0.0789564417883002
140120,Tuman,Lambayeque,Chiclayo,2340,23622,1820,27782,0.065510042473544
140201,Ferreñafe,Lambayeque,Ferreñafe,2995,28053,3181,34229,0.0929328931607701
140202,Cañaris,Lambayeque,Ferreñafe,1451,9861,54,11366,0.00475101178954777
140203,Incahuasi,Lambayeque,Ferreñafe,1746,11961,151,13858,0.0108962332226873
140204,Manuel Antonio Mesones Muro,Lambayeque,Ferreñafe,388,3191,229,3808,0.0601365546218487
140205,Pitipo,Lambayeque,Ferreñafe,1906,16362,1383,19651,0.0703780978067274
140206,Pueblo Nuevo,Lambayeque,Ferreñafe,1498,11749,1256,14503,0.0866027718403089
140301,Lambayeque,Lambayeque,Lambayeque,6895,57092,7438,71425,0.104137206860343
140302,Chochope,Lambayeque,Lambayeque,170,1065,172,1407,0.122245913290689
140303,Illimo,Lambayeque,Lambayeque,838,7494,524,8856,0.0591689250225836
140304,Jayanca,Lambayeque,Lambayeque,1904,13741,1559,17204,0.0906184608230644
140305,Mochumi,Lambayeque,Lambayeque,1892,15712,797,18401,0.0433128634313353
140306,Morrope,Lambayeque,Lambayeque,6478,40751,980,48209,0.0203281544939742
140307,Motupe,Lambayeque,Lambayeque,3098,24137,2601,29836,0.0871765652232203
140308,Olmos,Lambayeque,Lambayeque,4973,37876,3635,46484,0.0781989501764048
140309,Pacora,Lambayeque,Lambayeque,856,6663,541,8060,0.06712158808933
140310,Salas,Lambayeque,Lambayeque,1363,10841,391,12595,0.0310440651052005
140311,San José,Lambayeque,Lambayeque,1892,12705,1249,15846,0.078821153603433
140312,Tucume,Lambayeque,Lambayeque,2348,18482,1017,21847,0.0465510138691811
150101,Lima,Lima,Lima,15462,209257,43633,268352,0.162596142380157
150102,Ancón,Lima,Lima,5886,40267,16775,62928,0.2665744978388
150103,Ate,Lima,Lima,49355,460205,89636,599196,0.149593789010608
150104,Barranco,Lima,Lima,1675,24646,8057,34378,0.234365000872651
150105,Breña,Lima,Lima,4722,62075,18512,85309,0.216999378729091
150106,Carabayllo,Lima,Lima,30002,234461,68582,333045,0.205924124367578
150107,Chaclacayo,Lima,Lima,2842,34149,5921,42912,0.137980052199851
150108,Chorrillos,Lima,Lima,21091,247242,45908,314241,0.14609169395464
150109,Cieneguilla,Lima,Lima,3265,22942,8477,34684,0.24440664283243
150110,Comas,Lima,Lima,38827,420231,61392,520450,0.117959458161207
150111,El Agustino,Lima,Lima,15314,154152,29396,198862,0.147821102070783
150112,Independencia,Lima,Lima,15001,173013,23346,211360,0.110456093868282
150113,Jesús María,Lima,Lima,3379,50904,21076,75359,0.279674624132486
150114,La Molina,Lima,Lima,6606,107420,26653,140679,0.189459691922746
150115,La Victoria,Lima,Lima,10959,136570,26101,173630,0.15032540459598
150116,Lince,Lima,Lima,2623,38793,13295,54711,0.243004149074226
150117,Los Olivos,Lima,Lima,21912,250895,53077,325884,0.162870837475912
150118,Lurigancho,Lima,Lima,20992,175805,44017,240814,0.1827842235086
150119,Lurin,Lima,Lima,8108,63493,17594,89195,0.197253209260609
150120,Magdalena del Mar,Lima,Lima,3089,40132,17069,60290,0.28311494443523
150121,Pueblo Libre,Lima,Lima,3772,57738,21813,83323,0.261788461769259
150122,Miraflores,Lima,Lima,4678,64600,30059,99337,0.30259621289147
150123,Pachacamac,Lima,Lima,10712,78730,20629,110071,0.187415395517439
150124,Pucusana,Lima,Lima,1395,11110,2386,14891,0.160231012020684
150125,Puente Piedra,Lima,Lima,29953,239961,59761,329675,0.181272465306741
150126,Punta Hermosa,Lima,Lima,1386,9068,5420,15874,0.341438830792491
150127,Punta Negra,Lima,Lima,574,4964,1536,7074,0.217133163698049
150128,Rímac,Lima,Lima,11420,143534,19831,174785,0.113459392968504
150129,San Bartolo,Lima,Lima,562,5208,1712,7482,0.228815824645817
150130,San Borja,Lima,Lima,5277,82510,25460,113247,0.224818317483024
150131,San Isidro,Lima,Lima,2691,39961,18083,60735,0.297736066518482
150132,San Juan de Lurigancho,Lima,Lima,83236,834315,120944,1038495,0.116460839965527
150133,San Juan de Miraflores,Lima,Lima,23949,293027,38243,355219,0.107660344745073
150134,San Luis,Lima,Lima,2852,38835,10395,52082,0.199589109481203
150135,San Martín de Porres,Lima,Lima,45356,499826,108901,654083,0.166494160527028
150136,San Miguel,Lima,Lima,8531,108001,38852,155384,0.250038614014313
150137,Santa Anita,Lima,Lima,14702,148160,33352,196214,0.169977677433822
150138,Santa María del Mar,Lima,Lima,70,721,208,999,0.208208208208208
150139,Santa Rosa,Lima,Lima,2922,16801,8140,27863,0.292143703118831
150140,Santiago de Surco,Lima,Lima,16708,245682,66762,329152,0.202830303324908
150141,Surquillo,Lima,Lima,4758,65165,21100,91023,0.231809542643068
150142,Villa el Salvador,Lima,Lima,30365,325938,36951,393254,0.093962172031308
150143,Villa María del Triunfo,Lima,Lima,31122,327101,40210,398433,0.100920355492642
150201,Barranca,Lima,Barranca,5623,56056,6645,68324,0.0972571863474036
150202,Paramonga,Lima,Barranca,1543,18457,1453,21453,0.0677294550878665
150203,Pativilca,Lima,Barranca,1593,14400,1438,17431,0.0824967012793299
150204,Supe,Lima,Barranca,2309,19268,2741,24318,0.112714861419525
150205,Supe Puerto,Lima,Barranca,1142,9986,1727,12855,0.134344612991054
150301,Cajatambo,Lima,Cajatambo,132,1773,177,2082,0.085014409221902
150302,Copa,Lima,Cajatambo,68,758,32,858,0.0372960372960373
150303,Gorgor,Lima,Cajatambo,167,1434,71,1672,0.0424641148325359
150304,Huancapon,Lima,Cajatambo,59,862,63,984,0.0640243902439024
150305,Manas,Lima,Cajatambo,69,805,89,963,0.0924195223260644
150401,Canta,Lima,Canta,155,1976,254,2385,0.106498951781971
150402,Arahuay,Lima,Canta,29,501,66,596,0.110738255033557
150403,Huamantanga,Lima,Canta,39,558,89,686,0.129737609329446
150404,Huaros,Lima,Canta,63,641,56,760,0.0736842105263158
150405,Lachaqui,Lima,Canta,29,772,55,856,0.0642523364485981
150406,San Buenaventura,Lima,Canta,27,488,40,555,0.0720720720720721
150407,Santa Rosa de Quives,Lima,Canta,509,4588,613,5710,0.107355516637478
150501,San Vicente de Cañete,Lima,Cañete,4722,43326,6727,54775,0.122811501597444
150502,Asia,Lima,Cañete,1060,7605,1119,9784,0.114370400654129
150503,Calango,Lima,Cañete,160,1916,193,2269,0.0850594975760247
150504,Cerro Azul,Lima,Cañete,821,6468,1039,8328,0.124759846301633
150505,Chilca,Lima,Cañete,2097,16200,3276,21573,0.151856487275761
150506,Coayllo,Lima,Cañete,77,817,149,1043,0.142857142857143
150507,Imperial,Lima,Cañete,3679,32331,2915,38925,0.0748876043673732
150508,Lunahuana,Lima,Cañete,254,3651,488,4393,0.111085818347371
150509,Mala,Lima,Cañete,2928,26762,3027,32717,0.0925207078888651
150510,Nuevo Imperial,Lima,Cañete,2391,20309,3533,26233,0.134677696031716
150511,Pacaran,Lima,Cañete,158,1369,159,1686,0.0943060498220641
150512,Quilmana,Lima,Cañete,1710,12784,1597,16091,0.099248026847306
150513,San Antonio,Lima,Cañete,366,3372,605,4343,0.139304628137232
150514,San Luis,Lima,Cañete,1232,11002,1202,13436,0.0894611491515332
150515,Santa Cruz de Flores,Lima,Cañete,264,2454,385,3103,0.124073477280052
150516,Zúñiga,Lima,Cañete,97,1052,165,1314,0.125570776255708
150601,Huaral,Lima,Huaral,7945,84444,7526,99915,0.0753240254216084
150602,Atavillos Alto,Lima,Huaral,38,586,63,687,0.091703056768559
150603,Atavillos Bajo,Lima,Huaral,40,746,116,902,0.12860310421286
150604,Aucallama,Lima,Huaral,1402,15809,2253,19464,0.11575215782984
150605,Chancay,Lima,Huaral,5025,46846,5049,56920,0.0887034434293746
150606,Ihuari,Lima,Huaral,140,1814,83,2037,0.0407461953853706
150607,Lampian,Lima,Huaral,17,277,42,336,0.125
150608,Pacaraos,Lima,Huaral,63,860,105,1028,0.102140077821012
150609,San Miguel de Acos,Lima,Huaral,36,475,137,648,0.21141975308642
150610,Santa Cruz de Andamarca,Lima,Huaral,19,604,207,830,0.249397590361446
150611,Sumbilca,Lima,Huaral,25,630,65,720,0.0902777777777778
150612,Veintisiete de Noviembre,Lima,Huaral,18,337,56,411,0.13625304136253
150701,Matucana,Lima,Huarochirí,315,3490,253,4058,0.0623459832429768
150702,Antioquia,Lima,Huarochirí,98,995,132,1225,0.107755102040816
150703,Callahuanca,Lima,Huarochirí,50,668,80,798,0.100250626566416
150704,Carampoma,Lima,Huarochirí,23,272,36,331,0.108761329305136
150705,Chicla,Lima,Huarochirí,327,2795,704,3826,0.184004181913225
150706,Cuenca,Lima,Huarochirí,33,375,41,449,0.0913140311804009
150707,Huachupampa,Lima,Huarochirí,35,443,131,609,0.215106732348112
150708,Huanza,Lima,Huarochirí,47,603,225,875,0.257142857142857
150709,Huarochirí,Lima,Huarochirí,105,1095,102,1302,0.0783410138248848
150710,Lahuaytambo,Lima,Huarochirí,41,542,33,616,0.0535714285714286
150711,Langa,Lima,Huarochirí,65,742,82,889,0.0922384701912261
150712,San Pedro de Laraos,Lima,Huarochirí,28,584,54,666,0.0810810810810811
150713,Mariatana,Lima,Huarochirí,136,1181,40,1357,0.0294767870302137
150714,Ricardo Palma,Lima,Huarochirí,485,5155,902,6542,0.137878324671354
150715,San Andrés de Tupicocha,Lima,Huarochirí,155,1149,16,1320,0.0121212121212121
150716,San Antonio,Lima,Huarochirí,44,699,169,912,0.18530701754386
150717,San Bartolomé,Lima,Huarochirí,73,946,120,1139,0.105355575065847
150718,San Damian,Lima,Huarochirí,97,1052,53,1202,0.0440931780366057
150719,San Juan de Iris,Lima,Huarochirí,47,557,95,699,0.135908440629471
150720,San Juan de Tantaranche,Lima,Huarochirí,36,322,16,374,0.0427807486631016
150721,San Lorenzo de Quinti,Lima,Huarochirí,78,1062,83,1223,0.0678659035159444
150722,San Mateo,Lima,Huarochirí,348,3591,306,4245,0.0720848056537102
150723,San Mateo de Otao,Lima,Huarochirí,92,1193,50,1335,0.0374531835205993
150724,San Pedro de Casta,Lima,Huarochirí,44,838,46,928,0.0495689655172414
150725,San Pedro de Huancayre,Lima,Huarochirí,14,189,7,210,0.0333333333333333
150726,Sangallaya,Lima,Huarochirí,57,485,88,630,0.13968253968254
150727,Santa Cruz de Cocachacra,Lima,Huarochirí,183,1921,382,2486,0.153660498793242
150728,Santa Eulalia,Lima,Huarochirí,1029,10004,1603,12636,0.126859765748655
150729,Santiago de Anchucaya,Lima,Huarochirí,17,276,27,320,0.084375
150730,Santiago de Tuna,Lima,Huarochirí,23,370,18,411,0.0437956204379562
150731,Santo Domingo de los Olleros,Lima,Huarochirí,369,2088,668,3125,0.21376
150732,Surco,Lima,Huarochirí,92,1199,116,1407,0.0824449182658138
150801,Huacho,Lima,Huaura,4793,49971,8378,63142,0.1326850590732
150802,Ambar,Lima,Huaura,196,1942,70,2208,0.0317028985507246
150803,Caleta de Carquin,Lima,Huaura,575,5835,1722,8132,0.211756025577964
150804,Checras,Lima,Huaura,42,847,40,929,0.0430570505920344
150805,Hualmay,Lima,Huaura,2360,22894,3511,28765,0.122058056666087
150806,Huaura,Lima,Huaura,3170,28010,3584,34764,0.103095155908411
150807,Leoncio Prado,Lima,Huaura,151,1631,85,1867,0.0455275843599357
150808,Paccho,Lima,Huaura,110,1342,64,1516,0.0422163588390501
150809,Santa Leonor,Lima,Huaura,52,675,48,775,0.0619354838709677
150810,Santa María,Lima,Huaura,3252,27091,5924,36267,0.163344086910966
150811,Sayan,Lima,Huaura,2137,18822,2449,23408,0.104622351332878
150812,Vegueta,Lima,Huaura,2711,19029,4172,25912,0.161006483482556
150901,Oyón,Lima,Oyón,1055,8971,2124,12150,0.174814814814815
150902,Andajes,Lima,Oyón,22,477,47,546,0.0860805860805861
150903,Caujul,Lima,Oyón,57,476,43,576,0.0746527777777778
150904,Cochamarca,Lima,Oyón,90,961,35,1086,0.0322283609576427
150905,Navan,Lima,Oyón,61,740,54,855,0.0631578947368421
150906,Pachangara,Lima,Oyón,171,2005,350,2526,0.138558986539984
151001,Yauyos,Lima,Yauyos,102,1253,126,1481,0.0850776502363268
151002,Alis,Lima,Yauyos,20,682,832,1534,0.542372881355932
151003,Allauca,Lima,Yauyos,95,942,108,1145,0.0943231441048035
151004,Ayaviri,Lima,Yauyos,32,481,52,565,0.0920353982300885
151005,Azangaro,Lima,Yauyos,39,374,27,440,0.0613636363636364
151006,Cacra,Lima,Yauyos,46,416,45,507,0.0887573964497041
151007,Carania,Lima,Yauyos,14,139,9,162,0.0555555555555556
151008,Catahuasi,Lima,Yauyos,83,897,82,1062,0.0772128060263654
151009,Chocos,Lima,Yauyos,72,695,34,801,0.0424469413233458
151010,Cochas,Lima,Yauyos,12,180,24,216,0.111111111111111
151011,Colonia,Lima,Yauyos,73,1002,34,1109,0.0306582506762849
151012,Hongos,Lima,Yauyos,26,282,23,331,0.0694864048338369
151013,Huampara,Lima,Yauyos,4,115,30,149,0.201342281879195
151014,Huancaya,Lima,Yauyos,23,428,145,596,0.243288590604027
151015,Huangascar,Lima,Yauyos,46,507,84,637,0.131868131868132
151016,Huantan,Lima,Yauyos,60,560,321,941,0.341126461211477
151017,Huañec,Lima,Yauyos,11,351,70,432,0.162037037037037
151018,Laraos,Lima,Yauyos,37,419,90,546,0.164835164835165
151019,Lincha,Lima,Yauyos,39,401,7,447,0.0156599552572707
151020,Madean,Lima,Yauyos,54,491,25,570,0.043859649122807
151021,Miraflores,Lima,Yauyos,14,198,17,229,0.074235807860262
151022,Omas,Lima,Yauyos,23,528,42,593,0.0708263069139966
151023,Putinza,Lima,Yauyos,38,414,46,498,0.0923694779116466
151024,Quinches,Lima,Yauyos,30,558,21,609,0.0344827586206897
151025,Quinocay,Lima,Yauyos,28,366,34,428,0.0794392523364486
151026,San Joaquín,Lima,Yauyos,8,140,18,166,0.108433734939759
151027,San Pedro de Pilas,Lima,Yauyos,18,244,13,275,0.0472727272727273
151028,Tanta,Lima,Yauyos,21,461,25,507,0.0493096646942801
151029,Tauripampa,Lima,Yauyos,13,450,36,499,0.0721442885771543
151030,Tomas,Lima,Yauyos,36,423,61,520,0.117307692307692
151031,Tupe,Lima,Yauyos,52,442,39,533,0.0731707317073171
151032,Viñac,Lima,Yauyos,133,1416,75,1624,0.0461822660098522
151033,Vitis,Lima,Yauyos,9,276,26,311,0.0836012861736334
160101,Iquitos,Loreto,Maynas,10165,124977,11711,146853,0.0797464130797464
160102,Alto Nanay,Loreto,Maynas,355,2385,115,2855,0.0402802101576182
160103,Fernando Lores,Loreto,Maynas,1561,11784,530,13875,0.0381981981981982
160104,Indiana,Loreto,Maynas,1338,8251,545,10134,0.0537793566212749
160105,Las Amazonas,Loreto,Maynas,954,6783,295,8032,0.0367280876494024
160106,Mazan,Loreto,Maynas,1651,10088,442,12181,0.0362860192102455
160107,Napo,Loreto,Maynas,1887,12691,425,15003,0.0283276677997734
160108,Punchana,Loreto,Maynas,7945,58814,8451,75210,0.112365376944555
160110,Torres Causana,Loreto,Maynas,653,3426,151,4230,0.0356973995271868
160112,Belén,Loreto,Maynas,6802,50489,7197,64488,0.111602158541124
160113,San Juan Bautista,Loreto,Maynas,14257,90994,21754,127005,0.171284595094681
160201,Yurimaguas,Loreto,Alto Amazonas,9740,64998,8816,83554,0.10551260262824
160202,Balsapuerto,Loreto,Alto Amazonas,2394,11101,212,13707,0.0154665499379879
160205,Jeberos,Loreto,Alto Amazonas,586,3162,152,3900,0.038974358974359
160206,Lagunas,Loreto,Alto Amazonas,1531,10023,479,12033,0.0398071968752597
160210,Santa Cruz,Loreto,Alto Amazonas,577,3266,124,3967,0.0312578774892866
160211,Teniente Cesar López Rojas,Loreto,Alto Amazonas,720,4375,469,5564,0.0842918763479511
160301,Nauta,Loreto,Loreto,3709,24220,2034,29963,0.0678837232586857
160302,Parinari,Loreto,Loreto,755,5029,301,6085,0.0494658997534922
160303,Tigre,Loreto,Loreto,965,5313,170,6448,0.0263647642679901
160304,Trompeteros,Loreto,Loreto,1355,6669,372,8396,0.0443068127679848
160305,Urarinas,Loreto,Loreto,1678,9605,262,11545,0.0226938068427891
160401,Ramón Castilla,Loreto,Mariscal Ramón Castilla,2421,15872,885,19178,0.0461466263426843
160402,Pebas,Loreto,Mariscal Ramón Castilla,1440,9255,384,11079,0.0346601678851882
160403,Yavari,Loreto,Mariscal Ramón Castilla,1152,6819,395,8366,0.0472149175233086
160404,San Pablo,Loreto,Mariscal Ramón Castilla,1399,8800,250,10449,0.0239257345200498
160501,Requena,Loreto,Requena,3346,20616,1351,25313,0.0533717852486864
160502,Alto Tapiche,Loreto,Requena,212,1230,73,1515,0.0481848184818482
160503,Capelo,Loreto,Requena,316,2117,133,2566,0.0518316445830086
160504,Emilio San Martín,Loreto,Requena,790,5115,184,6089,0.0302184266710462
160505,Maquia,Loreto,Requena,998,6010,296,7304,0.04052573932092
160506,Puinahua,Loreto,Requena,577,3680,115,4372,0.0263037511436414
160507,Saquena,Loreto,Requena,417,2810,138,3365,0.0410104011887073
160508,Soplin,Loreto,Requena,96,433,40,569,0.070298769771529
160509,Tapiche,Loreto,Requena,110,708,63,881,0.0715096481271283
160510,Jenaro Herrera,Loreto,Requena,534,3879,195,4608,0.0423177083333333
160511,Yaquerana,Loreto,Requena,261,1598,70,1929,0.0362882322446864
160601,Contamana,Loreto,Ucayali,3021,19187,1675,23883,0.0701335678097392
160602,Inahuaya,Loreto,Ucayali,214,1386,138,1738,0.0794016110471807
160603,Padre Márquez,Loreto,Ucayali,456,3117,124,3697,0.0335407086827157
160604,Pampa Hermosa,Loreto,Ucayali,700,4371,317,5388,0.0588344469190794
160605,Sarayacu,Loreto,Ucayali,1788,11177,499,13464,0.0370617944147356
160606,Vargas Guerra,Loreto,Ucayali,680,5385,402,6467,0.0621617442399876
160701,Barranca,Loreto,Datem del Marañón,1589,9837,1316,12742,0.103280489719039
160702,Cahuapanas,Loreto,Datem del Marañón,1105,5170,61,6336,0.00962752525252525
160703,Manseriche,Loreto,Datem del Marañón,1315,6634,472,8421,0.0560503503146895
160704,Morona,Loreto,Datem del Marañón,615,3432,144,4191,0.0343593414459556
160705,Pastaza,Loreto,Datem del Marañón,761,4169,148,5078,0.0291453328081922
160706,Andoas,Loreto,Datem del Marañón,2119,9522,73,11714,0.0062318593136418
160801,Putumayo,Loreto,Putumayo,423,2856,387,3666,0.10556464811784
160802,Rosa Panduro,Loreto,Putumayo,64,412,44,520,0.0846153846153846
160803,Teniente Manuel Clavero,Loreto,Putumayo,300,1881,136,2317,0.0586965904186448
160804,Yaguas,Loreto,Putumayo,163,960,154,1277,0.120595144870791
170101,Tambopata,Madre de Dios,Tambopata,7850,62748,11327,81925,0.138260604211169
170102,Inambari,Madre de Dios,Tambopata,1403,7108,3059,11570,0.264390665514261
170103,Las Piedras,Madre de Dios,Tambopata,1496,7490,3658,12644,0.289307181271749
170104,Laberinto,Madre de Dios,Tambopata,579,3877,879,5335,0.164761012183693
170201,Manu,Madre de Dios,Manu,260,1722,374,2356,0.15874363327674
170202,Fitzcarrald,Madre de Dios,Manu,230,1048,124,1402,0.0884450784593438
170203,Madre de Dios,Madre de Dios,Manu,721,4096,1400,6217,0.225188997908959
170204,Huepetuhe,Madre de Dios,Manu,841,5908,1825,8574,0.21285281082342
170301,Iñapari,Madre de Dios,Tahuamanu,262,1287,842,2391,0.3521539104977
170302,Iberia,Madre de Dios,Tahuamanu,550,4229,1012,5791,0.174753928509757
170303,Tahuamanu,Madre de Dios,Tahuamanu,328,1712,825,2865,0.287958115183246
180101,Moquegua,Moquegua,Mariscal Nieto,5149,52754,7905,65808,0.120122173595915
180102,Carumas,Moquegua,Mariscal Nieto,94,2119,153,2366,0.0646661031276416
180103,Cuchumbaya,Moquegua,Mariscal Nieto,30,687,44,761,0.0578186596583443
180104,Samegua,Moquegua,Mariscal Nieto,616,6184,1680,8480,0.19811320754717
180105,San Cristóbal,Moquegua,Mariscal Nieto,78,1545,113,1736,0.0650921658986175
180106,Torata,Moquegua,Mariscal Nieto,309,4325,1564,6198,0.252339464343337
180201,Omate,Moquegua,General Sánchez Cerro,252,2487,419,3158,0.132678910702977
180202,Chojata,Moquegua,General Sánchez Cerro,56,592,60,708,0.0847457627118644
180203,Coalaque,Moquegua,General Sánchez Cerro,53,816,79,948,0.0833333333333333
180204,Ichuña,Moquegua,General Sánchez Cerro,209,2467,225,2901,0.077559462254395
180205,La Capilla,Moquegua,General Sánchez Cerro,33,553,40,626,0.0638977635782748
180206,Lloque,Moquegua,General Sánchez Cerro,37,494,39,570,0.068421052631579
180207,Matalaque,Moquegua,General Sánchez Cerro,18,386,51,455,0.112087912087912
180208,Puquina,Moquegua,General Sánchez Cerro,132,2119,125,2376,0.0526094276094276
180209,Quinistaquillas,Moquegua,General Sánchez Cerro,27,439,52,518,0.1003861003861
180210,Ubinas,Moquegua,General Sánchez Cerro,87,1528,126,1741,0.0723721998851235
180211,Yunga,Moquegua,General Sánchez Cerro,60,775,29,864,0.0335648148148148
180301,Ilo,Moquegua,Ilo,4998,55810,5671,66479,0.0853051339520751
180302,El Algarrobal,Moquegua,Ilo,508,2241,968,3717,0.260425073984396
180303,Pacocha,Moquegua,Ilo,278,3340,835,4453,0.187514035481698
190101,Chaupimarca,Pasco,Pasco,2425,20908,2294,25627,0.0895149646856831
190102,Huachon,Pasco,Pasco,481,3653,199,4333,0.0459266097392107
190103,Huariaca,Pasco,Pasco,677,5633,615,6925,0.0888086642599278
190104,Huayllay,Pasco,Pasco,684,7311,1582,9577,0.165187428213428
190105,Ninacaca,Pasco,Pasco,379,3296,202,3877,0.0521021408305391
190106,Pallanchacra,Pasco,Pasco,166,1505,67,1738,0.0385500575373993
190107,Paucartambo,Pasco,Pasco,943,9642,631,11216,0.0562589158345221
190108,San Francisco de Asís de Yarusyacan,Pasco,Pasco,303,3816,340,4459,0.076250280331913
190109,Simon Bolívar,Pasco,Pasco,1126,10408,1129,12663,0.0891573876648504
190110,Ticlacayan,Pasco,Pasco,298,2861,102,3261,0.031278748850046
190111,Tinyahuarco,Pasco,Pasco,594,5295,866,6755,0.12820133234641
190112,Vicco,Pasco,Pasco,269,2471,652,3392,0.192216981132075
190113,Yanacancha,Pasco,Pasco,2248,23990,2954,29192,0.101192107426692
190201,Yanahuanca,Pasco,Daniel Alcides Carrión,1024,9536,773,11333,0.0682078884673079
190202,Chacayan,Pasco,Daniel Alcides Carrión,139,1811,56,2006,0.0279162512462612
190203,Goyllarisquizga,Pasco,Daniel Alcides Carrión,111,1400,24,1535,0.0156351791530945
190204,Paucar,Pasco,Daniel Alcides Carrión,123,1575,78,1776,0.0439189189189189
190205,San Pedro de Pillao,Pasco,Daniel Alcides Carrión,93,1241,14,1348,0.0103857566765579
190206,Santa Ana de Tusi,Pasco,Daniel Alcides Carrión,1038,20050,129,21217,0.00608003016449074
190207,Tapuc,Pasco,Daniel Alcides Carrión,167,2123,136,2426,0.0560593569661995
190208,Vilcabamba,Pasco,Daniel Alcides Carrión,149,1718,72,1939,0.037132542547705
190301,Oxapampa,Pasco,Oxapampa,1290,11780,2607,15677,0.166294571665497
190302,Chontabamba,Pasco,Oxapampa,461,3947,926,5334,0.173603299587552
190303,Huancabamba,Pasco,Oxapampa,714,5395,552,6661,0.0828704398738928
190304,Palcazu,Pasco,Oxapampa,812,5768,550,7130,0.0771388499298738
190305,Pozuzo,Pasco,Oxapampa,443,3642,426,4511,0.0944358235424518
190306,Puerto Bermúdez,Pasco,Oxapampa,2187,13931,1131,17249,0.0655690184938257
190307,Villa Rica,Pasco,Oxapampa,1604,13769,1901,17274,0.110049785805256
190308,Constitución,Pasco,Oxapampa,1669,10180,1785,13634,0.130922693266833
200101,Piura,Piura,Piura,10502,132216,15777,158495,0.0995425723208934
200104,Castilla,Piura,Piura,14384,124777,21040,160201,0.131335010393194
200105,Catacaos,Piura,Piura,8120,64615,3135,75870,0.0413206801107157
200107,Cura Mori,Piura,Piura,2026,15968,677,18671,0.0362594397729099
200108,El Tallan,Piura,Piura,662,4525,200,5387,0.0371264154445888
200109,La Arena,Piura,Piura,4380,33549,805,38734,0.0207827748231528
200110,La Unión,Piura,Piura,4865,35365,1512,41742,0.036222509702458
200111,Las Lomas,Piura,Piura,2627,23201,1119,26947,0.041525958362712
200114,Tambo Grande,Piura,Piura,11616,93810,2069,107495,0.0192474068561328
200115,Veintiseis de Octubre,Piura,Piura,16218,83049,66512,165779,0.40120883827264
200201,Ayabaca,Piura,Ayabaca,2836,27133,883,30852,0.0286205108258784
200202,Frias,Piura,Ayabaca,2029,17579,288,19896,0.014475271411339
200203,Jilili,Piura,Ayabaca,235,2102,68,2405,0.0282744282744283
200204,Lagunas,Piura,Ayabaca,731,4907,96,5734,0.016742239274503
200205,Montero,Piura,Ayabaca,554,5475,150,6179,0.0242757727787668
200206,Pacaipampa,Piura,Ayabaca,2714,18260,283,21257,0.0133132615138543
200207,Paimas,Piura,Ayabaca,1013,8212,396,9621,0.0411599625818522
200208,Sapillica,Piura,Ayabaca,1345,9049,116,10510,0.0110371075166508
200209,Sicchez,Piura,Ayabaca,110,1463,81,1654,0.0489721886336155
200210,Suyo,Piura,Ayabaca,1089,9624,466,11179,0.0416853027998927
200301,Huancabamba,Piura,Huancabamba,2467,23732,1400,27599,0.0507264755969419
200302,Canchaque,Piura,Huancabamba,616,6282,419,7317,0.0572639059723931
200303,El Carmen de la Frontera,Piura,Huancabamba,1142,9915,129,11186,0.0115322724834615
200304,Huarmaca,Piura,Huancabamba,3978,30984,586,35548,0.0164847530100146
200305,Lalaquiz,Piura,Huancabamba,319,3470,82,3871,0.0211831568070266
200306,San Miguel de El Faique,Piura,Huancabamba,913,7487,278,8678,0.0320350311131597
200307,Sondor,Piura,Huancabamba,739,6150,251,7140,0.0351540616246499
200308,Sondorillo,Piura,Huancabamba,1117,8668,377,10162,0.0370989962605786
200401,Chulucanas,Piura,Morropón,8183,70871,3467,82521,0.0420135480665528
200402,Buenos Aires,Piura,Morropón,811,7873,726,9410,0.0771519659936238
200403,Chalaco,Piura,Morropón,673,6845,271,7789,0.034792656310181
200404,La Matanza,Piura,Morropón,1501,11891,605,13997,0.0432235479031221
200405,Morropón,Piura,Morropón,1301,12946,992,15239,0.0650961349169893
200406,Salitral,Piura,Morropón,808,7105,614,8527,0.0720065673742231
200407,San Juan de Bigote,Piura,Morropón,576,5571,286,6433,0.0444582620861185
200408,Santa Catalina de Mossa,Piura,Morropón,281,3133,236,3650,0.0646575342465753
200409,Santo Domingo,Piura,Morropón,353,5362,245,5960,0.0411073825503356
200410,Yamango,Piura,Morropón,739,7579,183,8501,0.0215268791906835
200501,Paita,Piura,Paita,9751,73337,4891,87979,0.0555928119210266
200502,Amotape,Piura,Paita,228,2056,129,2413,0.0534604227103191
200503,Arenal,Piura,Paita,93,973,70,1136,0.0616197183098592
200504,Colan,Piura,Paita,1614,12450,805,14869,0.0541394848342188
200505,La Huaca,Piura,Paita,1278,11170,502,12950,0.0387644787644788
200506,Tamarindo,Piura,Paita,475,4173,275,4923,0.0558602478163721
200507,Vichayal,Piura,Paita,689,4716,217,5622,0.0385983635716827
200601,Sullana,Piura,Sullana,15022,144815,9498,169335,0.056089999114182
200602,Bellavista,Piura,Sullana,3267,32388,1875,37530,0.0499600319744205
200603,Ignacio Escudero,Piura,Sullana,1852,17838,733,20423,0.0358909073103853
200604,Lancones,Piura,Sullana,1078,10821,220,12119,0.0181533129796188
200605,Marcavelica,Piura,Sullana,2738,25728,1103,29569,0.037302580405154
200606,Miguel Checa,Piura,Sullana,907,7681,448,9036,0.0495794599380257
200607,Querecotillo,Piura,Sullana,2518,22881,996,26395,0.0377344193976132
200608,Salitral,Piura,Sullana,588,6106,353,7047,0.0500922378317014
200701,Pariñas,Piura,Talara,8865,82012,7432,98309,0.0755983684098099
200702,El Alto,Piura,Talara,784,6978,554,8316,0.0666185666185666
200703,La Brea,Piura,Talara,1052,10702,732,12486,0.0586256607400288
200704,Lobitos,Piura,Talara,128,968,216,1312,0.164634146341463
200705,Los Organos,Piura,Talara,972,8552,1175,10699,0.109823347976446
200706,Mancora,Piura,Talara,1250,10232,1546,13028,0.118667485416027
200801,Sechura,Piura,Sechura,5810,36074,2706,44590,0.0606862525229872
200802,Bellavista de la Unión,Piura,Sechura,536,4045,217,4798,0.0452271779908295
200803,Bernal,Piura,Sechura,784,5778,293,6855,0.0427425237053246
200804,Cristo Nos Valga,Piura,Sechura,514,3501,285,4300,0.0662790697674419
200805,Vice,Piura,Sechura,2083,13163,384,15630,0.0245681381957774
200806,Rinconada Llicuar,Piura,Sechura,331,2536,137,3004,0.0456058588548602
210101,Puno,Puno,Puno,9655,112097,13536,135288,0.100053219797765
210102,Acora,Puno,Puno,1393,21084,484,22961,0.0210792212882714
210103,Amantani,Puno,Puno,248,3142,62,3452,0.0179606025492468
210104,Atuncolla,Puno,Puno,409,4049,97,4555,0.0212952799121844
210105,Capachica,Puno,Puno,445,6876,219,7540,0.0290450928381963
210106,Chucuito,Puno,Puno,447,6350,222,7019,0.0316284370993019
210107,Coata,Puno,Puno,608,5924,56,6588,0.00850030358227079
210108,Huata,Puno,Puno,269,2784,102,3155,0.0323296354992076
210109,Mañazo,Puno,Puno,423,4502,219,5144,0.0425738724727838
210110,Paucarcolla,Puno,Puno,292,3837,95,4224,0.0224905303030303
210111,Pichacani,Puno,Puno,401,5101,177,5679,0.0311674590596936
210112,Plateria,Puno,Puno,453,6546,122,7121,0.0171324252211768
210113,San Antonio,Puno,Puno,190,2203,20,2413,0.00828843762950684
210114,Tiquillaca,Puno,Puno,103,1414,77,1594,0.048306148055207
210115,Vilque,Puno,Puno,235,2462,64,2761,0.0231800072437523
210201,Azángaro,Puno,Azángaro,2801,25709,1560,30070,0.051878949118723
210202,Achaya,Puno,Azángaro,213,2584,29,2826,0.0102618542108988
210203,Arapa,Puno,Azángaro,517,6354,149,7020,0.0212250712250712
210204,Asillo,Puno,Azángaro,1131,13098,255,14484,0.0176056338028169
210205,Caminaca,Puno,Azángaro,222,2657,52,2931,0.017741385192767
210206,Chupa,Puno,Azángaro,422,5966,87,6475,0.0134362934362934
210207,José Domingo Choquehuanca,Puno,Azángaro,363,3855,244,4462,0.054683998207082
210208,Muñani,Puno,Azángaro,586,5758,101,6445,0.0156710628394104
210209,Potoni,Puno,Azángaro,349,3535,55,3939,0.013962934755014
210210,Saman,Puno,Azángaro,734,8800,111,9645,0.0115085536547434
210211,San Anton,Puno,Azángaro,661,6420,217,7298,0.0297341737462318
210212,San José,Puno,Azángaro,317,4436,65,4818,0.0134910751349108
210213,San Juan de Salinas,Puno,Azángaro,207,2592,42,2841,0.0147835269271383
210214,Santiago de Pupuja,Puno,Azángaro,288,3985,134,4407,0.0304061719990924
210215,Tirapata,Puno,Azángaro,259,2386,86,2731,0.031490296594654
210301,Macusani,Puno,Carabaya,1248,10428,988,12664,0.0780164245104233
210302,Ajoyani,Puno,Carabaya,167,1818,153,2138,0.0715622076707203
210303,Ayapata,Puno,Carabaya,630,8407,262,9299,0.0281750725884504
210304,Coasa,Puno,Carabaya,567,5772,94,6433,0.0146121560702627
210305,Corani,Puno,Carabaya,494,3637,109,4240,0.0257075471698113
210306,Crucero,Puno,Carabaya,835,7946,327,9108,0.0359025032938076
210307,Ituata,Puno,Carabaya,527,6845,154,7526,0.0204623970236513
210308,Ollachea,Puno,Carabaya,728,5029,333,6090,0.054679802955665
210309,San Gaban,Puno,Carabaya,552,5615,665,6832,0.0973360655737705
210310,Usicayos,Puno,Carabaya,664,8205,123,8992,0.0136788256227758
210401,Juli,Puno,Chucuito,1358,17803,612,19773,0.0309512972234866
210402,Desaguadero,Puno,Chucuito,1075,11464,1248,13787,0.0905200551243925
210403,Huacullani,Puno,Chucuito,527,8361,349,9237,0.0377828299231352
210404,Kelluyo,Puno,Chucuito,523,6726,97,7346,0.0132044650149741
210405,Pisacoma,Puno,Chucuito,341,7795,87,8223,0.0105800802626779
210406,Pomata,Puno,Chucuito,866,12506,335,13707,0.0244400671189903
210407,Zepita,Puno,Chucuito,1282,15469,178,16929,0.0105145017425719
210501,Ilave,Puno,El Collao,2887,41449,1682,46018,0.0365509148594028
210502,Capazo,Puno,El Collao,56,1043,31,1130,0.0274336283185841
210503,Pilcuyo,Puno,El Collao,517,10022,133,10672,0.0124625187406297
210504,Santa Rosa,Puno,El Collao,245,3056,228,3529,0.064607537546047
210505,Conduriri,Puno,El Collao,175,2304,50,2529,0.0197706603400554
210601,Huancané,Puno,Huancané,1239,16641,862,18742,0.0459929569949845
210602,Cojata,Puno,Huancané,321,3326,117,3764,0.0310839532412327
210603,Huatasani,Puno,Huancané,230,2756,97,3083,0.0314628608498216
210604,Inchupalla,Puno,Huancané,150,2367,125,2642,0.0473126419379258
210605,Pusi,Puno,Huancané,347,4483,107,4937,0.0216730808183107
210606,Rosaspata,Puno,Huancané,234,3763,82,4079,0.0201029664133366
210607,Taraco,Puno,Huancané,940,11975,278,13193,0.0210717804896536
210608,Vilque Chico,Puno,Huancané,323,6750,138,7211,0.0191374289280266
210701,Lampa,Puno,Lampa,885,9753,568,11206,0.0506871318936284
210702,Cabanilla,Puno,Lampa,442,4768,142,5352,0.0265321375186846
210703,Calapuja,Puno,Lampa,160,1340,85,1585,0.0536277602523659
210704,Nicasio,Puno,Lampa,202,2099,59,2360,0.025
210705,Ocuviri,Puno,Lampa,148,1727,362,2237,0.161823871256147
210706,Palca,Puno,Lampa,155,1606,56,1817,0.030820033021464
210707,Paratia,Puno,Lampa,220,2413,99,2732,0.0362371888726208
210708,Pucara,Puno,Lampa,378,4808,120,5306,0.0226159065209197
210709,Santa Lucia,Puno,Lampa,694,5767,567,7028,0.0806772908366534
210710,Vilavila,Puno,Lampa,119,1066,48,1233,0.0389294403892944
210801,Ayaviri,Puno,Melgar,1818,20401,2233,24452,0.0913217732700802
210802,Antauta,Puno,Melgar,398,4034,927,5359,0.172980033588356
210803,Cupi,Puno,Melgar,156,1741,89,1986,0.0448136958710977
210804,Llalli,Puno,Melgar,214,2220,98,2532,0.0387045813586098
210805,Macari,Puno,Melgar,528,6233,186,6947,0.0267741471138621
210806,Nuñoa,Puno,Melgar,618,7523,309,8450,0.0365680473372781
210807,Orurillo,Puno,Melgar,562,6938,151,7651,0.0197359822245458
210808,Santa Rosa,Puno,Melgar,454,5461,282,6197,0.0455058899467484
210809,Umachiri,Puno,Melgar,269,3038,257,3564,0.0721099887766555
210901,Moho,Puno,Moho  ,588,10696,234,11518,0.0203160270880361
210902,Conima,Puno,Moho  ,154,2913,84,3151,0.0266582037448429
210903,Huayrapata,Puno,Moho  ,157,2422,34,2613,0.0130118637581324
210904,Tilali,Puno,Moho  ,130,2288,53,2471,0.0214488061513557
211001,Putina,Puno,San Antonio de Putina,1217,12925,611,14753,0.0414153053616214
211002,Ananea,Puno,San Antonio de Putina,669,8156,3790,12615,0.300435988902101
211003,Pedro Vilca Apaza,Puno,San Antonio de Putina,125,1742,42,1909,0.0220010476689366
211004,Quilcapuncu,Puno,San Antonio de Putina,459,4589,139,5187,0.0267977636398689
211005,Sina,Puno,San Antonio de Putina,160,1347,142,1649,0.0861127956337174
211101,Juliaca,Puno,San Román,19608,184252,24866,228726,0.108715231324817
211102,Cabana,Puno,San Román,369,4333,141,4843,0.0291141854222589
211103,Cabanillas,Puno,San Román,381,3915,271,4567,0.059338734398949
211104,Caracoto,Puno,San Román,551,5741,526,6818,0.0771487239659724
211105,San Miguel,Puno,San Román,5697,15496,41270,62463,0.660711140995469
211201,Sandia,Puno,Sandia,781,9111,374,10266,0.036430937073836
211202,Cuyocuyo,Puno,Sandia,405,4500,119,5024,0.0236863057324841
211203,Limbani,Puno,Sandia,207,2577,186,2970,0.0626262626262626
211204,Patambuco,Puno,Sandia,338,3480,45,3863,0.0116489774786435
211205,Phara,Puno,Sandia,401,4406,284,5091,0.0557847181300334
211206,Quiaca,Puno,Sandia,139,1689,303,2131,0.142186766776161
211207,San Juan del Oro,Puno,Sandia,252,3264,217,3733,0.0581301901955532
211208,Yanahuaya,Puno,Sandia,155,1670,111,1936,0.0573347107438017
211209,Alto Inambari,Puno,Sandia,554,5679,371,6604,0.0561780738946093
211210,San Pedro de Putina Punco,Puno,Sandia,845,7013,1266,9124,0.138754932047348
211301,Yunguyo,Puno,Yunguyo,1555,22094,866,24515,0.0353253110340608
211302,Anapia,Puno,Yunguyo,94,1554,134,1782,0.0751964085297419
211303,Copani,Puno,Yunguyo,310,4260,85,4655,0.0182599355531686
211304,Cuturapi,Puno,Yunguyo,62,1176,32,1270,0.0251968503937008
211305,Ollaraya,Puno,Yunguyo,96,2571,44,2711,0.016230173367761
211306,Tinicachi,Puno,Yunguyo,48,883,18,949,0.0189673340358272
211307,Unicachi,Puno,Yunguyo,46,964,47,1057,0.0444654683065279
220101,Moyobamba,San Martín,Moyobamba,7400,59542,9383,76325,0.122934818211595
220102,Calzada,San Martín,Moyobamba,448,3617,544,4609,0.118029941418963
220103,Habana,San Martín,Moyobamba,158,1228,289,1675,0.172537313432836
220104,Jepelacio,San Martín,Moyobamba,1566,13054,757,15377,0.049229368537426
220105,Soritor,San Martín,Moyobamba,2206,17764,1544,21514,0.071767221344241
220106,Yantalo,San Martín,Moyobamba,283,2205,377,2865,0.131588132635253
220201,Bellavista,San Martín,Bellavista,1731,12632,2531,16894,0.149816502900438
220202,Alto Biavo,San Martín,Bellavista,907,5916,816,7639,0.106820264432517
220203,Bajo Biavo,San Martín,Bellavista,1510,10699,907,13116,0.0691521805428484
220204,Huallaga,San Martín,Bellavista,282,2107,322,2711,0.118775359645887
220205,San Pablo,San Martín,Bellavista,882,7263,495,8640,0.0572916666666667
220206,San Rafael,San Martín,Bellavista,649,4518,866,6033,0.143543842201227
220301,San José de Sisa,San Martín,El Dorado,1619,11982,1038,14639,0.0709064826832434
220302,Agua Blanca,San Martín,El Dorado,218,1981,131,2330,0.0562231759656652
220303,San Martín,San Martín,El Dorado,1247,8603,597,10447,0.0571455920359912
220304,Santa Rosa,San Martín,El Dorado,657,5378,297,6332,0.0469046114971573
220305,Shatoja,San Martín,El Dorado,334,2496,174,3004,0.0579227696404794
220401,Saposoa,San Martín,Huallaga,1256,10865,1301,13422,0.0969304127551781
220402,Alto Saposoa,San Martín,Huallaga,530,3377,564,4471,0.126146276000895
220403,El Eslabón,San Martín,Huallaga,206,1712,188,2106,0.0892687559354226
220404,Piscoyacu,San Martín,Huallaga,453,3339,476,4268,0.111527647610122
220405,Sacanche,San Martín,Huallaga,216,1980,254,2450,0.103673469387755
220406,Tingo de Saposoa,San Martín,Huallaga,58,649,82,789,0.103929024081115
220501,Lamas,San Martín,Lamas,1236,12085,1176,14497,0.0811202317720908
220502,Alonso de Alvarado,San Martín,Lamas,1434,11430,598,13462,0.0444213341256871
220503,Barranquita,San Martín,Lamas,675,5109,645,6429,0.100326644890341
220504,Caynarachi,San Martín,Lamas,1146,7232,1168,9546,0.122354913052587
220505,Cuñumbuqui,San Martín,Lamas,263,2800,238,3301,0.0720993638291427
220506,Pinto Recodo,San Martín,Lamas,818,6976,292,8086,0.036111798169676
220507,Rumisapa,San Martín,Lamas,301,2853,302,3456,0.0873842592592593
220508,San Roque de Cumbaza,San Martín,Lamas,175,1363,97,1635,0.0593272171253823
220509,Shanao,San Martín,Lamas,177,1690,108,1975,0.0546835443037975
220510,Tabalosos,San Martín,Lamas,1443,11656,780,13879,0.0562000144102601
220511,Zapatero,San Martín,Lamas,563,4331,361,5255,0.0686964795432921
220601,Juanjuí,San Martín,Mariscal Cáceres,3044,25432,3968,32444,0.122303045247195
220602,Campanilla,San Martín,Mariscal Cáceres,1455,9806,1444,12705,0.113656040928768
220603,Huicungo,San Martín,Mariscal Cáceres,1014,6240,1131,8385,0.134883720930233
220604,Pachiza,San Martín,Mariscal Cáceres,659,4406,682,5747,0.118670610753437
220605,Pajarillo,San Martín,Mariscal Cáceres,589,4233,523,5345,0.0978484565014032
220701,Picota,San Martín,Picota,1006,7773,1424,10203,0.139566794080173
220702,Buenos Aires,San Martín,Picota,286,2387,251,2924,0.0858413132694938
220703,Caspisapa,San Martín,Picota,199,1663,264,2126,0.1241768579492
220704,Pilluana,San Martín,Picota,79,713,73,865,0.084393063583815
220705,Pucacaca,San Martín,Picota,291,2219,461,2971,0.155166610568832
220706,San Cristóbal,San Martín,Picota,128,904,160,1192,0.134228187919463
220707,San Hilarión,San Martín,Picota,416,2982,547,3945,0.138656527249683
220708,Shamboyacu,San Martín,Picota,1110,6812,632,8554,0.0738835632452654
220709,Tingo de Ponasa,San Martín,Picota,388,3094,394,3876,0.101651186790506
220710,Tres Unidos,San Martín,Picota,364,3177,348,3889,0.0894831576240679
220801,Rioja,San Martín,Rioja,2439,19971,3111,25521,0.121899612084166
220802,Awajun,San Martín,Rioja,991,5975,513,7479,0.0685920577617329
220803,Elías Soplin Vargas,San Martín,Rioja,2181,12587,2893,17661,0.16380725893211
220804,Nueva Cajamarca,San Martín,Rioja,4538,33741,5197,43476,0.119537215935229
220805,Pardo Miguel,San Martín,Rioja,1850,13662,1285,16797,0.0765017562659999
220806,Posic,San Martín,Rioja,237,1288,394,1919,0.205315268368942
220807,San Fernando,San Martín,Rioja,370,2774,269,3413,0.0788162906533841
220808,Yorongos,San Martín,Rioja,240,2057,149,2446,0.0609157808667212
220809,Yuracyacu,San Martín,Rioja,358,3118,356,3832,0.092901878914405
220901,Tarapoto,San Martín,San Martín,5844,57904,12374,76122,0.162554846167994
220902,Alberto Leveau,San Martín,San Martín,75,673,93,841,0.110582639714625
220903,Cacatachi,San Martín,San Martín,312,2728,564,3604,0.156492785793563
220904,Chazuta,San Martín,San Martín,1174,7734,589,9497,0.062019585132147
220905,Chipurana,San Martín,San Martín,306,1647,296,2249,0.131614050689195
220906,El Porvenir,San Martín,San Martín,268,1691,440,2399,0.183409754064193
220907,Huimbayoc,San Martín,San Martín,644,3838,493,4975,0.0990954773869347
220908,Juan Guerra,San Martín,San Martín,319,3049,539,3907,0.137957512157666
220909,La Banda de Shilcayo,San Martín,San Martín,4163,30637,8681,43481,0.199650422023413
220910,Morales,San Martín,San Martín,2711,22284,8072,33067,0.244110442435056
220911,Papaplaya,San Martín,San Martín,262,1673,138,2073,0.0665701881331404
220912,San Antonio,San Martín,San Martín,140,1297,237,1674,0.1415770609319
220913,Sauce,San Martín,San Martín,748,5675,840,7263,0.115654688145394
220914,Shapaja,San Martín,San Martín,160,1602,181,1943,0.0931549150797735
221001,Tocache,San Martín,Tocache,2507,20605,3054,26166,0.116716349461133
221002,Nuevo Progreso,San Martín,Tocache,1212,8425,1819,11456,0.158781424581006
221003,Polvora,San Martín,Tocache,1012,7901,1395,10308,0.135331781140861
221004,Shunte,San Martín,Tocache,174,997,144,1315,0.109505703422053
221005,Uchiza,San Martín,Tocache,2007,15021,3121,20149,0.154896024616606
230101,Tacna,Tacna,Tacna,5777,73346,13849,92972,0.148958826313299
230102,Alto de la Alianza,Tacna,Tacna,2177,27809,4075,34061,0.119638295998356
230103,Calana,Tacna,Tacna,187,2361,431,2979,0.144679422625042
230104,Ciudad Nueva,Tacna,Tacna,2521,25521,3824,31866,0.120002510512772
230105,Inclan,Tacna,Tacna,192,2214,207,2613,0.0792192881745121
230106,Pachia,Tacna,Tacna,125,1666,271,2062,0.131425800193986
230107,Palca,Tacna,Tacna,90,1391,499,1980,0.252020202020202
230108,Pocollay,Tacna,Tacna,1217,13839,3571,18627,0.191710957212648
230109,Sama,Tacna,Tacna,212,2525,490,3227,0.151843817787419
230110,Coronel Gregorio Albarracin Lanchipa,Tacna,Tacna,9442,81292,19683,110417,0.178260593930282
230111,La Yarada los Palos,Tacna,Tacna,458,4398,703,5559,0.126461593811837
230201,Candarave,Tacna,Candarave,133,2102,119,2354,0.0505522514868309
230202,Cairani,Tacna,Candarave,52,913,23,988,0.0232793522267207
230203,Camilaca,Tacna,Candarave,66,1030,52,1148,0.0452961672473868
230204,Curibaya,Tacna,Candarave,18,282,77,377,0.204244031830239
230205,Huanuara,Tacna,Candarave,29,456,30,515,0.058252427184466
230206,Quilahuani,Tacna,Candarave,47,639,34,720,0.0472222222222222
230301,Locumba,Tacna,Jorge Basadre,187,1810,259,2256,0.114804964539007
230302,Ilabaya,Tacna,Jorge Basadre,381,3853,1461,5695,0.256540825285338
230303,Ite,Tacna,Jorge Basadre,180,1853,789,2822,0.27958894401134
230401,Tarata,Tacna,Tarata,225,2495,922,3642,0.253157605711148
230402,Héroes Albarracín,Tacna,Tarata,14,277,15,306,0.0490196078431373
230403,Estique,Tacna,Tarata,11,205,24,240,0.1
230404,Estique-Pampa,Tacna,Tarata,6,130,26,162,0.160493827160494
230405,Sitajara,Tacna,Tarata,10,294,46,350,0.131428571428571
230406,Susapaya,Tacna,Tarata,16,477,25,518,0.0482625482625483
230407,Tarucachi,Tacna,Tarata,13,270,12,295,0.0406779661016949
230408,Ticaco,Tacna,Tarata,38,515,28,581,0.0481927710843374
240101,Tumbes,Tumbes,Tumbes,9124,85447,7735,102306,0.0756065137919575
240102,Corrales,Tumbes,Tumbes,2347,19471,1519,23337,0.0650897716073189
240103,La Cruz,Tumbes,Tumbes,941,7756,810,9507,0.0852003786683496
240104,Pampas de Hospital,Tumbes,Tumbes,636,5711,381,6728,0.0566290130796671
240105,San Jacinto,Tumbes,Tumbes,735,7308,469,8512,0.0550986842105263
240106,San Juan de la Virgen,Tumbes,Tumbes,426,3800,346,4572,0.0756780402449694
240201,Zorritos,Tumbes,Contralmirante Villar,1219,9836,1316,12371,0.10637781909304
240202,Casitas,Tumbes,Contralmirante Villar,176,1961,213,2350,0.0906382978723404
240203,Canoas de Punta Sal,Tumbes,Contralmirante Villar,688,4708,940,6336,0.148358585858586
240301,Zarumilla,Tumbes,Zarumilla,2334,17337,2105,21776,0.0966660543717854
240302,Aguas Verdes,Tumbes,Zarumilla,2000,13681,1685,17366,0.0970286767246344
240303,Matapalo,Tumbes,Zarumilla,410,2252,766,3428,0.223453908984831
240304,Papayal,Tumbes,Zarumilla,659,4948,667,6274,0.10631176283073
250101,Calleria,Ucayali,Coronel Portillo,14142,116731,19126,149999,0.127507516716778
250102,Campoverde,Ucayali,Coronel Portillo,1851,11703,2505,16059,0.155987296842892
250103,Iparia,Ucayali,Coronel Portillo,1660,8360,308,10328,0.0298218435321456
250104,Masisea,Ucayali,Coronel Portillo,1649,9019,479,11147,0.0429712030142639
250105,Yarinacocha,Ucayali,Coronel Portillo,11268,77909,14764,103941,0.142042120048874
250106,Nueva Requena,Ucayali,Coronel Portillo,697,3759,713,5169,0.137937705552331
250107,Manantay,Ucayali,Coronel Portillo,10395,65973,11157,87525,0.127472150814053
250201,Raymondi,Ucayali,Atalaya,4924,24944,2562,32430,0.0790009250693802
250202,Sepahua,Ucayali,Atalaya,954,5054,647,6655,0.0972201352366642
250203,Tahuania,Ucayali,Atalaya,1317,6561,386,8264,0.0467086156824782
250204,Yurua,Ucayali,Atalaya,334,1520,121,1975,0.0612658227848101
250301,Padre Abad,Ucayali,Padre Abad,3344,22944,3152,29440,0.107065217391304
250302,Irazola,Ucayali,Padre Abad,1146,7868,1200,10214,0.117485803798708
250303,Curimana,Ucayali,Padre Abad,941,5432,1349,7722,0.174695674695675
250304,Neshuya,Ucayali,Padre Abad,933,5221,1440,7594,0.189623386884382
250305,Alexander Von Humboldt,Ucayali,Padre Abad,559,3849,729,5137,0.141911621569009
250401,Purús,Ucayali,Purús,370,2332,158,2860,0.0552447552447552
TOTAL,"",,"",2494300,23286249,3601335,29381884,0.12256991416888
,"",,"",,,,,
,"",,"",,,,,
,"",,"",,,,,
